"filename", "language", "JSON", "JSON with Comments", "Markdown", "TypeScript", "JavaScript", "comment", "blank", "total"
"d:\typescript-algorithms\.prettierrc", "JSON", 7, 0, 0, 0, 0, 0, 1, 8
"d:\typescript-algorithms\README.md", "Markdown", 0, 0, 2, 0, 0, 0, 2, 4
"d:\typescript-algorithms\babel.config.js", "JavaScript", 0, 0, 0, 0, 6, 0, 1, 7
"d:\typescript-algorithms\package.json", "JSON", 22, 0, 0, 0, 0, 0, 1, 23
"d:\typescript-algorithms\src\algorithms\array\crud\__test__\index.test.ts", "TypeScript", 0, 0, 0, 20, 0, 0, 4, 24
"d:\typescript-algorithms\src\algorithms\array\crud\index.ts", "TypeScript", 0, 0, 0, 18, 0, 0, 3, 21
"d:\typescript-algorithms\src\algorithms\linked-list\reverse-traversal\__test__\reverseTraversal.test.ts", "TypeScript", 0, 0, 0, 16, 0, 0, 6, 22
"d:\typescript-algorithms\src\algorithms\linked-list\reverse-traversal\reverseTraversal.ts", "TypeScript", 0, 0, 0, 8, 0, 0, 2, 10
"d:\typescript-algorithms\src\algorithms\linked-list\traversal\__test__\traversal.test.ts", "TypeScript", 0, 0, 0, 16, 0, 0, 6, 22
"d:\typescript-algorithms\src\algorithms\linked-list\traversal\traversal.ts", "TypeScript", 0, 0, 0, 8, 0, 0, 2, 10
"d:\typescript-algorithms\src\algorithms\shuffle\kruth.ts", "TypeScript", 0, 0, 0, 7, 0, 0, 1, 8
"d:\typescript-algorithms\src\algorithms\sort\__test__\index.test.ts", "TypeScript", 0, 0, 0, 50, 0, 0, 10, 60
"d:\typescript-algorithms\src\algorithms\sort\heapSort.ts", "TypeScript", 0, 0, 0, 83, 0, 8, 10, 101
"d:\typescript-algorithms\src\algorithms\sort\insertSort.ts", "TypeScript", 0, 0, 0, 11, 0, 0, 1, 12
"d:\typescript-algorithms\src\algorithms\sort\mergeSort.ts", "TypeScript", 0, 0, 0, 48, 0, 0, 6, 54
"d:\typescript-algorithms\src\algorithms\sort\quickSort.ts", "TypeScript", 0, 0, 0, 73, 0, 1, 11, 85
"d:\typescript-algorithms\src\algorithms\sort\selectSort.ts", "TypeScript", 0, 0, 0, 11, 0, 0, 1, 12
"d:\typescript-algorithms\src\algorithms\sort\shellSort.ts", "TypeScript", 0, 0, 0, 15, 0, 1, 2, 18
"d:\typescript-algorithms\src\algorithms\topK\__test__\topK.test.ts", "TypeScript", 0, 0, 0, 10, 0, 0, 2, 12
"d:\typescript-algorithms\src\algorithms\topK\topK.ts", "TypeScript", 0, 0, 0, 36, 0, 0, 7, 43
"d:\typescript-algorithms\src\algorithms\union-find\__test__\index.test.ts", "TypeScript", 0, 0, 0, 41, 0, 0, 4, 45
"d:\typescript-algorithms\src\algorithms\union-find\quick-find\quickFind.ts", "TypeScript", 0, 0, 0, 20, 0, 0, 5, 25
"d:\typescript-algorithms\src\algorithms\union-find\quick-union\quickUnion.ts", "TypeScript", 0, 0, 0, 22, 0, 0, 5, 27
"d:\typescript-algorithms\src\algorithms\union-find\quick-union\weightedPathComPressionQuickUnion.ts", "TypeScript", 0, 0, 0, 35, 0, 2, 6, 43
"d:\typescript-algorithms\src\data-structures\linked-list\LinkedList.ts", "TypeScript", 0, 0, 0, 231, 0, 15, 38, 284
"d:\typescript-algorithms\src\data-structures\linked-list\LinkedListNode.ts", "TypeScript", 0, 0, 0, 10, 0, 0, 2, 12
"d:\typescript-algorithms\src\data-structures\linked-list\__test__\LinkedList.test.ts", "TypeScript", 0, 0, 0, 112, 0, 0, 14, 126
"d:\typescript-algorithms\src\data-structures\priority-queue\PriorityQueue.ts", "TypeScript", 0, 0, 0, 170, 0, 11, 21, 202
"d:\typescript-algorithms\src\data-structures\priority-queue\__test__\PriorityQueue.test.ts", "TypeScript", 0, 0, 0, 103, 0, 0, 10, 113
"d:\typescript-algorithms\src\data-structures\stack\Stack.ts", "TypeScript", 0, 0, 0, 33, 0, 0, 7, 40
"d:\typescript-algorithms\src\data-structures\stack\__test__\Stack.test.ts", "TypeScript", 0, 0, 0, 55, 0, 0, 16, 71
"d:\typescript-algorithms\src\data-structures\vector\Vector.ts", "TypeScript", 0, 0, 0, 130, 0, 12, 23, 165
"d:\typescript-algorithms\src\data-structures\vector\__test__\Vector.test.ts", "TypeScript", 0, 0, 0, 130, 0, 0, 16, 146
"d:\typescript-algorithms\src\interview\call\index.ts", "TypeScript", 0, 0, 0, 15, 0, 0, 1, 16
"d:\typescript-algorithms\src\interview\debounce\index.ts", "TypeScript", 0, 0, 0, 32, 0, 0, 3, 35
"d:\typescript-algorithms\src\interview\deep-copy\index.ts", "TypeScript", 0, 0, 0, 10, 0, 0, 1, 11
"d:\typescript-algorithms\src\interview\es5\map\index.ts", "TypeScript", 0, 0, 0, 12, 0, 0, 1, 13
"d:\typescript-algorithms\src\interview\flat\index.ts", "TypeScript", 0, 0, 0, 52, 0, 7, 8, 67
"d:\typescript-algorithms\src\interview\new\index.ts", "TypeScript", 0, 0, 0, 18, 0, 0, 4, 22
"d:\typescript-algorithms\src\interview\promise\all.ts", "TypeScript", 0, 0, 0, 20, 0, 0, 1, 21
"d:\typescript-algorithms\src\interview\promise\finally.ts", "TypeScript", 0, 0, 0, 9, 0, 0, 1, 10
"d:\typescript-algorithms\src\interview\promise\race.ts", "TypeScript", 0, 0, 0, 7, 0, 0, 1, 8
"d:\typescript-algorithms\src\interview\promise\sequence.ts", "TypeScript", 0, 0, 0, 21, 0, 0, 2, 23
"d:\typescript-algorithms\src\interview\setTimeout\index.ts", "TypeScript", 0, 0, 0, 34, 0, 5, 11, 50
"d:\typescript-algorithms\src\interview\throttle\index.ts", "TypeScript", 0, 0, 0, 25, 0, 0, 3, 28
"d:\typescript-algorithms\src\leetcode\Bit operations\137. Single Number II\firstSubmission.ts", "TypeScript", 0, 0, 0, 13, 0, 0, 1, 14
"d:\typescript-algorithms\src\leetcode\Bit operations\191. Number of 1 Bits\finalSubmission.ts", "TypeScript", 0, 0, 0, 8, 0, 0, 1, 9
"d:\typescript-algorithms\src\leetcode\Bit operations\191. Number of 1 Bits\firstSubmission.ts", "TypeScript", 0, 0, 0, 8, 0, 0, 1, 9
"d:\typescript-algorithms\src\leetcode\Bit operations\231. Power of Two\finalSubmission.ts", "TypeScript", 0, 0, 0, 3, 0, 0, 1, 4
"d:\typescript-algorithms\src\leetcode\Bit operations\231. Power of Two\firstSubmission.ts", "TypeScript", 0, 0, 0, 11, 0, 0, 1, 12
"d:\typescript-algorithms\src\leetcode\hot 100\1. Two Sum\firstSubmission.ts", "TypeScript", 0, 0, 0, 12, 0, 0, 2, 14
"d:\typescript-algorithms\src\leetcode\hot 100\10. Regular Expression Matching\firstSubmission.ts", "TypeScript", 0, 0, 0, 13, 0, 0, 1, 14
"d:\typescript-algorithms\src\leetcode\hot 100\101. Symmetric Tree\TreeNode.ts", "TypeScript", 0, 0, 0, 10, 0, 0, 1, 11
"d:\typescript-algorithms\src\leetcode\hot 100\101. Symmetric Tree\finalSubmission.ts", "TypeScript", 0, 0, 0, 28, 0, 13, 8, 49
"d:\typescript-algorithms\src\leetcode\hot 100\101. Symmetric Tree\firstSubmission.ts", "TypeScript", 0, 0, 0, 17, 0, 13, 5, 35
"d:\typescript-algorithms\src\leetcode\hot 100\102. Binary Tree Level Order Traversal\TreeNode.ts", "TypeScript", 0, 0, 0, 10, 0, 0, 1, 11
"d:\typescript-algorithms\src\leetcode\hot 100\102. Binary Tree Level Order Traversal\__test__\index.test.ts", "TypeScript", 0, 0, 0, 13, 0, 0, 2, 15
"d:\typescript-algorithms\src\leetcode\hot 100\102. Binary Tree Level Order Traversal\firstSubmission.ts", "TypeScript", 0, 0, 0, 25, 0, 0, 2, 27
"d:\typescript-algorithms\src\leetcode\hot 100\104. Maximum Depth of Binary Tree\TreeNode.ts", "TypeScript", 0, 0, 0, 10, 0, 0, 1, 11
"d:\typescript-algorithms\src\leetcode\hot 100\104. Maximum Depth of Binary Tree\finalSubmission.ts", "TypeScript", 0, 0, 0, 24, 0, 13, 5, 42
"d:\typescript-algorithms\src\leetcode\hot 100\104. Maximum Depth of Binary Tree\firstSubmission.ts", "TypeScript", 0, 0, 0, 7, 0, 13, 4, 24
"d:\typescript-algorithms\src\leetcode\hot 100\105. Construct Binary Tree from Preorder and Inorder Traversal\TreeNode.ts", "TypeScript", 0, 0, 0, 10, 0, 0, 1, 11
"d:\typescript-algorithms\src\leetcode\hot 100\105. Construct Binary Tree from Preorder and Inorder Traversal\finalSubmission.ts", "TypeScript", 0, 0, 0, 29, 0, 6, 6, 41
"d:\typescript-algorithms\src\leetcode\hot 100\105. Construct Binary Tree from Preorder and Inorder Traversal\firstSubmission.ts", "TypeScript", 0, 0, 0, 18, 0, 14, 7, 39
"d:\typescript-algorithms\src\leetcode\hot 100\11. Container With Most Water\finalSubmission.ts", "TypeScript", 0, 0, 0, 17, 0, 0, 2, 19
"d:\typescript-algorithms\src\leetcode\hot 100\11. Container With Most Water\firstSubmission.ts", "TypeScript", 0, 0, 0, 15, 0, 0, 2, 17
"d:\typescript-algorithms\src\leetcode\hot 100\114. Flatten Binary Tree to Linked List\TreeNode.ts", "TypeScript", 0, 0, 0, 10, 0, 0, 1, 11
"d:\typescript-algorithms\src\leetcode\hot 100\114. Flatten Binary Tree to Linked List\firstSubmission.ts", "TypeScript", 0, 0, 0, 23, 0, 16, 5, 44
"d:\typescript-algorithms\src\leetcode\hot 100\114. Flatten Binary Tree to Linked List\secondSubmission.ts", "TypeScript", 0, 0, 0, 23, 0, 16, 4, 43
"d:\typescript-algorithms\src\leetcode\hot 100\121. Best Time to Buy and Sell Stock\firstSubmission.ts", "TypeScript", 0, 0, 0, 12, 0, 1, 2, 15
"d:\typescript-algorithms\src\leetcode\hot 100\121. Best Time to Buy and Sell Stock\secondSubmission.ts", "TypeScript", 0, 0, 0, 13, 0, 0, 1, 14
"d:\typescript-algorithms\src\leetcode\hot 100\124. Binary Tree Maximum Path Sum\TreeNode.ts", "TypeScript", 0, 0, 0, 10, 0, 0, 1, 11
"d:\typescript-algorithms\src\leetcode\hot 100\124. Binary Tree Maximum Path Sum\firstSubmission.ts", "TypeScript", 0, 0, 0, 15, 0, 15, 6, 36
"d:\typescript-algorithms\src\leetcode\hot 100\128. Longest Consecutive Sequence\firstSubmission.ts", "TypeScript", 0, 0, 0, 17, 0, 0, 4, 21
"d:\typescript-algorithms\src\leetcode\hot 100\128. Longest Consecutive Sequence\secondSubmission.ts", "TypeScript", 0, 0, 0, 42, 0, 2, 11, 55
"d:\typescript-algorithms\src\leetcode\hot 100\136. Single Number\finalSubmission.ts", "TypeScript", 0, 0, 0, 3, 0, 0, 1, 4
"d:\typescript-algorithms\src\leetcode\hot 100\136. Single Number\firstSubmission.ts", "TypeScript", 0, 0, 0, 8, 0, 0, 2, 10
"d:\typescript-algorithms\src\leetcode\hot 100\136. Single Number\secondSubmission.ts", "TypeScript", 0, 0, 0, 16, 0, 0, 3, 19
"d:\typescript-algorithms\src\leetcode\hot 100\139. Word Break\finalSubmission.ts", "TypeScript", 0, 0, 0, 22, 0, 2, 3, 27
"d:\typescript-algorithms\src\leetcode\hot 100\139. Word Break\firstSubmission.ts", "TypeScript", 0, 0, 0, 34, 0, 0, 2, 36
"d:\typescript-algorithms\src\leetcode\hot 100\139. Word Break\secondSubmission.ts", "TypeScript", 0, 0, 0, 22, 0, 0, 3, 25
"d:\typescript-algorithms\src\leetcode\hot 100\141. Linked List Cycle\ListNode.ts", "TypeScript", 0, 0, 0, 8, 0, 0, 1, 9
"d:\typescript-algorithms\src\leetcode\hot 100\141. Linked List Cycle\finalSubmission.ts", "TypeScript", 0, 0, 0, 12, 0, 0, 2, 14
"d:\typescript-algorithms\src\leetcode\hot 100\141. Linked List Cycle\firstSubmission.ts", "TypeScript", 0, 0, 0, 13, 0, 11, 4, 28
"d:\typescript-algorithms\src\leetcode\hot 100\141. Linked List Cycle\secondSubmission.ts", "TypeScript", 0, 0, 0, 13, 0, 0, 4, 17
"d:\typescript-algorithms\src\leetcode\hot 100\142. Linked List Cycle II\ListNode.ts", "TypeScript", 0, 0, 0, 8, 0, 0, 1, 9
"d:\typescript-algorithms\src\leetcode\hot 100\142. Linked List Cycle II\firstSubmission.ts", "TypeScript", 0, 0, 0, 12, 0, 11, 4, 27
"d:\typescript-algorithms\src\leetcode\hot 100\146. LRU Cache\finalSubmission.ts", "TypeScript", 0, 0, 0, 71, 0, 1, 8, 80
"d:\typescript-algorithms\src\leetcode\hot 100\146. LRU Cache\firstSubmission.ts", "TypeScript", 0, 0, 0, 34, 0, 9, 8, 51
"d:\typescript-algorithms\src\leetcode\hot 100\146. LRU Cache\secondSubmission.ts", "TypeScript", 0, 0, 0, 29, 0, 0, 3, 32
"d:\typescript-algorithms\src\leetcode\hot 100\15. 3Sum\__test__\index.test.ts", "TypeScript", 0, 0, 0, 7, 0, 0, 3, 10
"d:\typescript-algorithms\src\leetcode\hot 100\15. 3Sum\finalSubmission.ts", "TypeScript", 0, 0, 0, 33, 0, 5, 1, 39
"d:\typescript-algorithms\src\leetcode\hot 100\15. 3Sum\firstSubmission.ts", "TypeScript", 0, 0, 0, 19, 0, 0, 2, 21
"d:\typescript-algorithms\src\leetcode\hot 100\15. 3Sum\secondSubmission.ts", "TypeScript", 0, 0, 0, 26, 0, 1, 8, 35
"d:\typescript-algorithms\src\leetcode\hot 100\152. Maximum Product Subarray\firstSubmission.ts", "TypeScript", 0, 0, 0, 21, 0, 1, 4, 26
"d:\typescript-algorithms\src\leetcode\hot 100\155. Min Stack\firstSubmission.ts", "TypeScript", 0, 0, 0, 25, 0, 8, 6, 39
"d:\typescript-algorithms\src\leetcode\hot 100\160. Intersection of Two Linked Lists\ListNode.ts", "TypeScript", 0, 0, 0, 8, 0, 0, 1, 9
"d:\typescript-algorithms\src\leetcode\hot 100\160. Intersection of Two Linked Lists\finalSubmission.ts", "TypeScript", 0, 0, 0, 16, 0, 0, 3, 19
"d:\typescript-algorithms\src\leetcode\hot 100\160. Intersection of Two Linked Lists\firstSubmission.ts", "TypeScript", 0, 0, 0, 21, 0, 11, 3, 35
"d:\typescript-algorithms\src\leetcode\hot 100\169. Majority Element\finnalSubmission.ts", "TypeScript", 0, 0, 0, 16, 0, 0, 2, 18
"d:\typescript-algorithms\src\leetcode\hot 100\169. Majority Element\firstSubmission.ts", "TypeScript", 0, 0, 0, 19, 0, 0, 2, 21
"d:\typescript-algorithms\src\leetcode\hot 100\169. Majority Element\secondSubmission.ts", "TypeScript", 0, 0, 0, 22, 0, 1, 2, 25
"d:\typescript-algorithms\src\leetcode\hot 100\17. Letter Combinations of a Phone Number\firstSubmission.ts", "TypeScript", 0, 0, 0, 30, 0, 0, 2, 32
"d:\typescript-algorithms\src\leetcode\hot 100\19. Remove Nth Node From End of List\ListNode.ts", "TypeScript", 0, 0, 0, 8, 0, 0, 1, 9
"d:\typescript-algorithms\src\leetcode\hot 100\19. Remove Nth Node From End of List\__test__\index.test.ts", "TypeScript", 0, 0, 0, 9, 0, 0, 2, 11
"d:\typescript-algorithms\src\leetcode\hot 100\19. Remove Nth Node From End of List\firstSubmission.ts", "TypeScript", 0, 0, 0, 28, 0, 11, 4, 43
"d:\typescript-algorithms\src\leetcode\hot 100\198. House Robber\firstSubmission.ts", "TypeScript", 0, 0, 0, 10, 0, 1, 2, 13
"d:\typescript-algorithms\src\leetcode\hot 100\2. Add Two Numbers\ListNode.ts", "TypeScript", 0, 0, 0, 8, 0, 0, 1, 9
"d:\typescript-algorithms\src\leetcode\hot 100\2. Add Two Numbers\firstSubmisstion.ts", "TypeScript", 0, 0, 0, 63, 0, 14, 6, 83
"d:\typescript-algorithms\src\leetcode\hot 100\20. Valid Parentheses\firstSubmission.ts", "TypeScript", 0, 0, 0, 20, 0, 0, 2, 22
"d:\typescript-algorithms\src\leetcode\hot 100\200. Number of Islands\finalSubmission.ts", "TypeScript", 0, 0, 0, 70, 0, 0, 9, 79
"d:\typescript-algorithms\src\leetcode\hot 100\200. Number of Islands\firstSubmission.ts", "TypeScript", 0, 0, 0, 42, 0, 0, 5, 47
"d:\typescript-algorithms\src\leetcode\hot 100\206. Reverse Linked List\ListNode.ts", "TypeScript", 0, 0, 0, 8, 0, 0, 1, 9
"d:\typescript-algorithms\src\leetcode\hot 100\206. Reverse Linked List\firstSubmission.ts", "TypeScript", 0, 0, 0, 12, 0, 11, 3, 26
"d:\typescript-algorithms\src\leetcode\hot 100\207. Course Schedule\firstSubmission.ts", "TypeScript", 0, 0, 0, 33, 0, 0, 2, 35
"d:\typescript-algorithms\src\leetcode\hot 100\208. Implement Trie (Prefix Tree)\firstSubmission.ts", "TypeScript", 0, 0, 0, 37, 0, 7, 7, 51
"d:\typescript-algorithms\src\leetcode\hot 100\21. Merge Two Sorted Lists\ListNode.ts", "TypeScript", 0, 0, 0, 8, 0, 0, 1, 9
"d:\typescript-algorithms\src\leetcode\hot 100\21. Merge Two Sorted Lists\firstSubmission.ts", "TypeScript", 0, 0, 0, 22, 0, 11, 5, 38
"d:\typescript-algorithms\src\leetcode\hot 100\215. Kth Largest Element in an Array\__test__\index.test.ts", "TypeScript", 0, 0, 0, 8, 0, 0, 1, 9
"d:\typescript-algorithms\src\leetcode\hot 100\215. Kth Largest Element in an Array\firstSubmission.ts", "TypeScript", 0, 0, 0, 68, 0, 0, 8, 76
"d:\typescript-algorithms\src\leetcode\hot 100\22. Generate Parentheses\firstSubmission.ts", "TypeScript", 0, 0, 0, 29, 0, 0, 2, 31
"d:\typescript-algorithms\src\leetcode\hot 100\221. Maximal Square\firstSubmission.ts", "TypeScript", 0, 0, 0, 31, 0, 0, 5, 36
"d:\typescript-algorithms\src\leetcode\hot 100\226. Invert Binary Tree\TreeNode.ts", "TypeScript", 0, 0, 0, 10, 0, 0, 1, 11
"d:\typescript-algorithms\src\leetcode\hot 100\226. Invert Binary Tree\firstSubmission.ts", "TypeScript", 0, 0, 0, 19, 0, 13, 4, 36
"d:\typescript-algorithms\src\leetcode\hot 100\226. Invert Binary Tree\secondSubmission.ts", "TypeScript", 0, 0, 0, 17, 0, 13, 4, 34
"d:\typescript-algorithms\src\leetcode\hot 100\234. Palindrome Linked List\ListNode.ts", "TypeScript", 0, 0, 0, 8, 0, 0, 1, 9
"d:\typescript-algorithms\src\leetcode\hot 100\234. Palindrome Linked List\firstSubmission.ts", "TypeScript", 0, 0, 0, 33, 0, 11, 5, 49
"d:\typescript-algorithms\src\leetcode\hot 100\236. Lowest Common Ancestor of a Binary Tree\TreeNode.ts", "TypeScript", 0, 0, 0, 10, 0, 0, 1, 11
"d:\typescript-algorithms\src\leetcode\hot 100\236. Lowest Common Ancestor of a Binary Tree\firstSubmission.ts", "TypeScript", 0, 0, 0, 35, 0, 13, 4, 52
"d:\typescript-algorithms\src\leetcode\hot 100\238. Product of Array Except Self\finalSubmission.ts", "TypeScript", 0, 0, 0, 14, 0, 0, 3, 17
"d:\typescript-algorithms\src\leetcode\hot 100\238. Product of Array Except Self\firstSubmission.ts", "TypeScript", 0, 0, 0, 18, 0, 0, 3, 21
"d:\typescript-algorithms\src\leetcode\hot 100\239. Sliding Window Maximum\firstSubmission.ts", "TypeScript", 0, 0, 0, 22, 0, 1, 3, 26
"d:\typescript-algorithms\src\leetcode\hot 100\240. Search a 2D Matrix II\finalSubmission.ts", "TypeScript", 0, 0, 0, 17, 0, 3, 2, 22
"d:\typescript-algorithms\src\leetcode\hot 100\240. Search a 2D Matrix II\firstSubmission.ts", "TypeScript", 0, 0, 0, 24, 0, 0, 4, 28
"d:\typescript-algorithms\src\leetcode\hot 100\279. Perfect Squares\firstSubmission.ts", "TypeScript", 0, 0, 0, 11, 0, 0, 2, 13
"d:\typescript-algorithms\src\leetcode\hot 100\283. Move Zeroes\finalSubmission.ts", "TypeScript", 0, 0, 0, 12, 0, 4, 1, 17
"d:\typescript-algorithms\src\leetcode\hot 100\283. Move Zeroes\firstSubmission.ts", "TypeScript", 0, 0, 0, 8, 0, 3, 1, 12
"d:\typescript-algorithms\src\leetcode\hot 100\283. Move Zeroes\secondSubmission.ts", "TypeScript", 0, 0, 0, 15, 0, 3, 3, 21
"d:\typescript-algorithms\src\leetcode\hot 100\287. Find the Duplicate Number\finalSubmission.ts", "TypeScript", 0, 0, 0, 14, 0, 0, 2, 16
"d:\typescript-algorithms\src\leetcode\hot 100\287. Find the Duplicate Number\firstSubmission.ts", "TypeScript", 0, 0, 0, 8, 0, 1, 2, 11
"d:\typescript-algorithms\src\leetcode\hot 100\287. Find the Duplicate Number\secondSubmission.ts", "TypeScript", 0, 0, 0, 11, 0, 1, 2, 14
"d:\typescript-algorithms\src\leetcode\hot 100\287. Find the Duplicate Number\thirdSubmission.ts", "TypeScript", 0, 0, 0, 24, 0, 1, 1, 26
"d:\typescript-algorithms\src\leetcode\hot 100\297. Serialize and Deserialize Binary Tree\TreeNode.ts", "TypeScript", 0, 0, 0, 10, 0, 0, 1, 11
"d:\typescript-algorithms\src\leetcode\hot 100\297. Serialize and Deserialize Binary Tree\firstSubmission.ts", "TypeScript", 0, 0, 0, 42, 0, 19, 6, 67
"d:\typescript-algorithms\src\leetcode\hot 100\3. Longest Substring Without Repeating Characters\firstSubmission.ts", "TypeScript", 0, 0, 0, 14, 0, 4, 2, 20
"d:\typescript-algorithms\src\leetcode\hot 100\300. Longest Increasing Subsequence\firstSubmission.ts", "TypeScript", 0, 0, 0, 18, 0, 1, 4, 23
"d:\typescript-algorithms\src\leetcode\hot 100\301. Remove Invalid Parentheses\firstSubmission.ts", "TypeScript", 0, 0, 0, 41, 0, 0, 3, 44
"d:\typescript-algorithms\src\leetcode\hot 100\309. Best Time to Buy and Sell Stock with Cooldown\firstSubmission.ts", "TypeScript", 0, 0, 0, 13, 0, 7, 2, 22
"d:\typescript-algorithms\src\leetcode\hot 100\31. Next Permutation\__test__\index.test.ts", "TypeScript", 0, 0, 0, 8, 0, 0, 2, 10
"d:\typescript-algorithms\src\leetcode\hot 100\31. Next Permutation\firstSubmission.ts", "TypeScript", 0, 0, 0, 25, 0, 3, 2, 30
"d:\typescript-algorithms\src\leetcode\hot 100\312. Burst Balloons\firstSubmission.ts", "TypeScript", 0, 0, 0, 27, 0, 3, 2, 32
"d:\typescript-algorithms\src\leetcode\hot 100\32. Longest Valid Parentheses\firstSubmission.ts", "TypeScript", 0, 0, 0, 18, 0, 2, 2, 22
"d:\typescript-algorithms\src\leetcode\hot 100\322. Coin Change\firstSubmission.ts", "TypeScript", 0, 0, 0, 15, 0, 3, 1, 19
"d:\typescript-algorithms\src\leetcode\hot 100\337. House Robber III\TreeNode.ts", "TypeScript", 0, 0, 0, 10, 0, 0, 1, 11
"d:\typescript-algorithms\src\leetcode\hot 100\337. House Robber III\firstSubmission.ts", "TypeScript", 0, 0, 0, 20, 0, 15, 6, 41
"d:\typescript-algorithms\src\leetcode\hot 100\338. Counting Bits\firstSubmission.ts", "TypeScript", 0, 0, 0, 13, 0, 0, 2, 15
"d:\typescript-algorithms\src\leetcode\hot 100\34. Find First and Last Position of Element in Sorted Array\binarySearch.ts", "TypeScript", 0, 0, 0, 25, 0, 0, 3, 28
"d:\typescript-algorithms\src\leetcode\hot 100\34. Find First and Last Position of Element in Sorted Array\finalSubmission.ts", "TypeScript", 0, 0, 0, 33, 0, 0, 4, 37
"d:\typescript-algorithms\src\leetcode\hot 100\34. Find First and Last Position of Element in Sorted Array\firstSubmission.ts", "TypeScript", 0, 0, 0, 5, 0, 0, 2, 7
"d:\typescript-algorithms\src\leetcode\hot 100\347. Top K Frequent Elements\finalSubmission.ts", "TypeScript", 0, 0, 0, 85, 0, 1, 6, 92
"d:\typescript-algorithms\src\leetcode\hot 100\347. Top K Frequent Elements\firstSubmission.ts", "TypeScript", 0, 0, 0, 16, 0, 0, 1, 17
"d:\typescript-algorithms\src\leetcode\hot 100\347. Top K Frequent Elements\secondSubmission.ts", "TypeScript", 0, 0, 0, 45, 0, 1, 6, 52
"d:\typescript-algorithms\src\leetcode\hot 100\39. Combination Sum\firstSubmission.ts", "TypeScript", 0, 0, 0, 21, 0, 2, 5, 28
"d:\typescript-algorithms\src\leetcode\hot 100\394. Decode String\firstSubmission.ts", "TypeScript", 0, 0, 0, 33, 0, 1, 2, 36
"d:\typescript-algorithms\src\leetcode\hot 100\399. Evaluate Division\firstSubmission.ts", "TypeScript", 0, 0, 0, 55, 0, 3, 4, 62
"d:\typescript-algorithms\src\leetcode\hot 100\4. Median of Two Sorted Arrays\firstSubmission.ts", "TypeScript", 0, 0, 0, 25, 0, 0, 5, 30
"d:\typescript-algorithms\src\leetcode\hot 100\4. Median of Two Sorted Arrays\secondSubmission.ts", "TypeScript", 0, 0, 0, 30, 0, 0, 2, 32
"d:\typescript-algorithms\src\leetcode\hot 100\406. Queue Reconstruction by Height\firstSubmission.ts", "TypeScript", 0, 0, 0, 14, 0, 2, 1, 17
"d:\typescript-algorithms\src\leetcode\hot 100\416. Partition Equal Subset Sum\firstSubmission.ts", "TypeScript", 0, 0, 0, 35, 0, 3, 3, 41
"d:\typescript-algorithms\src\leetcode\hot 100\42. Trapping Rain Water\firstSubmission.ts", "TypeScript", 0, 0, 0, 19, 0, 0, 3, 22
"d:\typescript-algorithms\src\leetcode\hot 100\437. Path Sum III\TreeNode.ts", "TypeScript", 0, 0, 0, 10, 0, 0, 1, 11
"d:\typescript-algorithms\src\leetcode\hot 100\437. Path Sum III\firstSubmission.ts", "TypeScript", 0, 0, 0, 23, 0, 15, 3, 41
"d:\typescript-algorithms\src\leetcode\hot 100\438. Find All Anagrams in a String\firstSubmission.ts", "TypeScript", 0, 0, 0, 40, 0, 0, 2, 42
"d:\typescript-algorithms\src\leetcode\hot 100\448. Find All Numbers Disappeared in an Array\finalSubmission.ts", "TypeScript", 0, 0, 0, 14, 0, 0, 1, 15
"d:\typescript-algorithms\src\leetcode\hot 100\448. Find All Numbers Disappeared in an Array\firstSubmission.ts", "TypeScript", 0, 0, 0, 14, 0, 0, 2, 16
"d:\typescript-algorithms\src\leetcode\hot 100\448. Find All Numbers Disappeared in an Array\secondSubmission.ts", "TypeScript", 0, 0, 0, 13, 0, 0, 1, 14
"d:\typescript-algorithms\src\leetcode\hot 100\46. Permutations\__test__\index.test.ts", "TypeScript", 0, 0, 0, 15, 0, 0, 2, 17
"d:\typescript-algorithms\src\leetcode\hot 100\46. Permutations\firstSubmission.ts", "TypeScript", 0, 0, 0, 15, 0, 0, 7, 22
"d:\typescript-algorithms\src\leetcode\hot 100\461. Hamming Distance\finalSubmission.ts", "TypeScript", 0, 0, 0, 9, 0, 0, 1, 10
"d:\typescript-algorithms\src\leetcode\hot 100\461. Hamming Distance\firstSubmission.ts", "TypeScript", 0, 0, 0, 31, 0, 0, 1, 32
"d:\typescript-algorithms\src\leetcode\hot 100\48. Rotate Image\firstSubmission.ts", "TypeScript", 0, 0, 0, 16, 0, 4, 2, 22
"d:\typescript-algorithms\src\leetcode\hot 100\48. Rotate Image\secondSubmission.ts", "TypeScript", 0, 0, 0, 12, 0, 4, 1, 17
"d:\typescript-algorithms\src\leetcode\hot 100\49. Group Anagrams\firstSubmission.ts", "TypeScript", 0, 0, 0, 18, 0, 0, 1, 19
"d:\typescript-algorithms\src\leetcode\hot 100\494. Target Sum\finalSubmission.ts", "TypeScript", 0, 0, 0, 23, 0, 5, 3, 31
"d:\typescript-algorithms\src\leetcode\hot 100\494. Target Sum\firstSubmission.ts", "TypeScript", 0, 0, 0, 20, 0, 0, 1, 21
"d:\typescript-algorithms\src\leetcode\hot 100\5. Longest Palindromic Substring\__test__\index.test.ts", "TypeScript", 0, 0, 0, 7, 0, 0, 2, 9
"d:\typescript-algorithms\src\leetcode\hot 100\5. Longest Palindromic Substring\finalSubmission.ts", "TypeScript", 0, 0, 0, 38, 0, 0, 3, 41
"d:\typescript-algorithms\src\leetcode\hot 100\5. Longest Palindromic Substring\firstSubmission.ts", "TypeScript", 0, 0, 0, 35, 0, 4, 3, 42
"d:\typescript-algorithms\src\leetcode\hot 100\53. Maximum Subarray\firstSubmission.ts", "TypeScript", 0, 0, 0, 11, 0, 0, 1, 12
"d:\typescript-algorithms\src\leetcode\hot 100\538. Convert BST to Greater Tree\TreeNode.ts", "TypeScript", 0, 0, 0, 10, 0, 0, 1, 11
"d:\typescript-algorithms\src\leetcode\hot 100\538. Convert BST to Greater Tree\firstSubmission.ts", "TypeScript", 0, 0, 0, 14, 0, 14, 6, 34
"d:\typescript-algorithms\src\leetcode\hot 100\543. Diameter of Binary Tree\TreeNode.ts", "TypeScript", 0, 0, 0, 10, 0, 0, 1, 11
"d:\typescript-algorithms\src\leetcode\hot 100\543. Diameter of Binary Tree\firstSubmission.ts", "TypeScript", 0, 0, 0, 15, 0, 13, 4, 32
"d:\typescript-algorithms\src\leetcode\hot 100\55. Jump Game\firstSubmission.ts", "TypeScript", 0, 0, 0, 10, 0, 0, 2, 12
"d:\typescript-algorithms\src\leetcode\hot 100\56. Merge Intervals\__test__\index.test.ts", "TypeScript", 0, 0, 0, 22, 0, 0, 2, 24
"d:\typescript-algorithms\src\leetcode\hot 100\56. Merge Intervals\firstSubmission.ts", "TypeScript", 0, 0, 0, 30, 0, 0, 2, 32
"d:\typescript-algorithms\src\leetcode\hot 100\56. Merge Intervals\secondSubmission.ts", "TypeScript", 0, 0, 0, 18, 0, 0, 1, 19
"d:\typescript-algorithms\src\leetcode\hot 100\560. Subarray Sum Equals K\finalSubmission.ts", "TypeScript", 0, 0, 0, 18, 0, 3, 1, 22
"d:\typescript-algorithms\src\leetcode\hot 100\560. Subarray Sum Equals K\firstSubmission.ts", "TypeScript", 0, 0, 0, 13, 0, 0, 1, 14
"d:\typescript-algorithms\src\leetcode\hot 100\581. Shortest Unsorted Continuous Subarray\firstSubmission.ts", "TypeScript", 0, 0, 0, 20, 0, 1, 1, 22
"d:\typescript-algorithms\src\leetcode\hot 100\617. Merge Two Binary Trees\TreeNode.ts", "TypeScript", 0, 0, 0, 10, 0, 0, 1, 11
"d:\typescript-algorithms\src\leetcode\hot 100\617. Merge Two Binary Trees\finalSubmission.ts", "TypeScript", 0, 0, 0, 16, 0, 0, 2, 18
"d:\typescript-algorithms\src\leetcode\hot 100\617. Merge Two Binary Trees\firstSubmission.ts", "TypeScript", 0, 0, 0, 55, 0, 0, 2, 57
"d:\typescript-algorithms\src\leetcode\hot 100\62. Unique Paths\__test__\index.test.ts", "TypeScript", 0, 0, 0, 7, 0, 0, 2, 9
"d:\typescript-algorithms\src\leetcode\hot 100\62. Unique Paths\firstSubmission.ts", "TypeScript", 0, 0, 0, 20, 0, 1, 1, 22
"d:\typescript-algorithms\src\leetcode\hot 100\621. Task Scheduler\firstSubmission.ts", "TypeScript", 0, 0, 0, 35, 0, 4, 5, 44
"d:\typescript-algorithms\src\leetcode\hot 100\64. Minimum Path Sum\firstSubmission.ts", "TypeScript", 0, 0, 0, 18, 0, 0, 2, 20
"d:\typescript-algorithms\src\leetcode\hot 100\647. Palindromic Substrings\firstSubmission.ts", "TypeScript", 0, 0, 0, 34, 0, 0, 3, 37
"d:\typescript-algorithms\src\leetcode\hot 100\647. Palindromic Substrings\secondSubmission.ts", "TypeScript", 0, 0, 0, 14, 0, 0, 1, 15
"d:\typescript-algorithms\src\leetcode\hot 100\70. Climbing Stairs\firstSubmission.ts", "TypeScript", 0, 0, 0, 9, 0, 0, 2, 11
"d:\typescript-algorithms\src\leetcode\hot 100\72. Edit Distance\firstSubmission.ts", "TypeScript", 0, 0, 0, 27, 0, 0, 2, 29
"d:\typescript-algorithms\src\leetcode\hot 100\739. Daily Temperatures\firstSubmission.ts", "TypeScript", 0, 0, 0, 16, 0, 0, 1, 17
"d:\typescript-algorithms\src\leetcode\hot 100\75. Sort Colors\finalSubmission.ts", "TypeScript", 0, 0, 0, 15, 0, 4, 2, 21
"d:\typescript-algorithms\src\leetcode\hot 100\75. Sort Colors\firstSubmission.ts", "TypeScript", 0, 0, 0, 12, 0, 4, 1, 17
"d:\typescript-algorithms\src\leetcode\hot 100\75. Sort Colors\secondSubmission.ts", "TypeScript", 0, 0, 0, 14, 0, 4, 1, 19
"d:\typescript-algorithms\src\leetcode\hot 100\76. Minimum Window Substring\__test__\index.test.ts", "TypeScript", 0, 0, 0, 6, 0, 0, 2, 8
"d:\typescript-algorithms\src\leetcode\hot 100\76. Minimum Window Substring\firstSubmission.ts", "TypeScript", 0, 0, 0, 34, 0, 2, 4, 40
"d:\typescript-algorithms\src\leetcode\hot 100\78. Subsets\firstSubmission.ts", "TypeScript", 0, 0, 0, 13, 0, 0, 2, 15
"d:\typescript-algorithms\src\leetcode\hot 100\79. Word Search\firstSubmission.ts", "TypeScript", 0, 0, 0, 43, 0, 0, 8, 51
"d:\typescript-algorithms\src\leetcode\hot 100\84. Largest Rectangle in Histogram\finalSubmission.ts", "TypeScript", 0, 0, 0, 29, 0, 4, 12, 45
"d:\typescript-algorithms\src\leetcode\hot 100\84. Largest Rectangle in Histogram\firstSubmission.ts", "TypeScript", 0, 0, 0, 12, 0, 0, 4, 16
"d:\typescript-algorithms\src\leetcode\hot 100\84. Largest Rectangle in Histogram\secondSubmission.ts", "TypeScript", 0, 0, 0, 17, 0, 0, 3, 20
"d:\typescript-algorithms\src\leetcode\hot 100\85. Maximal Rectangle\finalSubmission.ts", "TypeScript", 0, 0, 0, 48, 0, 0, 5, 53
"d:\typescript-algorithms\src\leetcode\hot 100\85. Maximal Rectangle\firstSubmission.ts", "TypeScript", 0, 0, 0, 37, 0, 0, 8, 45
"d:\typescript-algorithms\src\leetcode\hot 100\94. Binary Tree Inorder Traversal\TreeNode.ts", "TypeScript", 0, 0, 0, 10, 0, 0, 1, 11
"d:\typescript-algorithms\src\leetcode\hot 100\94. Binary Tree Inorder Traversal\finalSubmission.ts", "TypeScript", 0, 0, 0, 15, 0, 13, 5, 33
"d:\typescript-algorithms\src\leetcode\hot 100\94. Binary Tree Inorder Traversal\firstSubmission.ts", "TypeScript", 0, 0, 0, 14, 0, 13, 5, 32
"d:\typescript-algorithms\src\leetcode\hot 100\96. Unique Binary Search Trees\README.md", "Markdown", 0, 0, 11, 0, 0, 0, 3, 14
"d:\typescript-algorithms\src\leetcode\hot 100\96. Unique Binary Search Trees\finalSubmission.ts", "TypeScript", 0, 0, 0, 7, 0, 0, 1, 8
"d:\typescript-algorithms\src\leetcode\hot 100\96. Unique Binary Search Trees\firstSubmission.ts", "TypeScript", 0, 0, 0, 11, 0, 2, 3, 16
"d:\typescript-algorithms\src\leetcode\hot 100\98. Validate Binary Search Tree\TreeNode.ts", "TypeScript", 0, 0, 0, 10, 0, 0, 1, 11
"d:\typescript-algorithms\src\leetcode\hot 100\98. Validate Binary Search Tree\firstSubmission.ts", "TypeScript", 0, 0, 0, 19, 0, 13, 5, 37
"d:\typescript-algorithms\src\leetcode\hot 100\98. Validate Binary Search Tree\secondSubmission.ts", "TypeScript", 0, 0, 0, 18, 0, 13, 5, 36
"d:\typescript-algorithms\src\leetcode\linked-list\剑指 Offer 35. 复杂链表的复制\ListNode.ts", "TypeScript", 0, 0, 0, 10, 0, 0, 1, 11
"d:\typescript-algorithms\src\leetcode\linked-list\剑指 Offer 35. 复杂链表的复制\firstSubmission.ts", "TypeScript", 0, 0, 0, 21, 0, 13, 2, 36
"d:\typescript-algorithms\src\leetcode\linked-list\剑指 Offer II 024. 反转链表\ListNode.ts", "TypeScript", 0, 0, 0, 8, 0, 0, 1, 9
"d:\typescript-algorithms\src\leetcode\linked-list\剑指 Offer II 024. 反转链表\firstSubmission.ts", "TypeScript", 0, 0, 0, 12, 0, 14, 3, 29
"d:\typescript-algorithms\src\leetcode\linked-list\剑指 Offer II 026. 重排链表\ListNode.ts", "TypeScript", 0, 0, 0, 8, 0, 0, 1, 9
"d:\typescript-algorithms\src\leetcode\linked-list\剑指 Offer II 026. 重排链表\finalSubmission.ts", "TypeScript", 0, 0, 0, 44, 0, 17, 7, 68
"d:\typescript-algorithms\src\leetcode\linked-list\剑指 Offer II 026. 重排链表\firstSubmission.ts", "TypeScript", 0, 0, 0, 22, 0, 22, 11, 55
"d:\typescript-algorithms\src\leetcode\linked-list\剑指 Offer II 026. 重排链表\secondSubmission.ts", "TypeScript", 0, 0, 0, 29, 0, 15, 3, 47
"d:\typescript-algorithms\src\leetcode\linked-list\剑指 Offer II 027. 回文链表\ListNode.ts", "TypeScript", 0, 0, 0, 8, 0, 0, 1, 9
"d:\typescript-algorithms\src\leetcode\linked-list\剑指 Offer II 027. 回文链表\firstSubmission.ts", "TypeScript", 0, 0, 0, 16, 0, 14, 3, 33
"d:\typescript-algorithms\src\leetcode\linked-list\剑指 Offer II 027. 回文链表\secondSubmission.ts", "TypeScript", 0, 0, 0, 33, 0, 15, 3, 51
"d:\typescript-algorithms\src\leetcode\linked-list\剑指 Offer II 077. 链表排序\ListNode.ts", "TypeScript", 0, 0, 0, 8, 0, 0, 1, 9
"d:\typescript-algorithms\src\leetcode\linked-list\剑指 Offer II 077. 链表排序\finalSubmission.ts", "TypeScript", 0, 0, 0, 63, 0, 31, 9, 103
"d:\typescript-algorithms\src\leetcode\linked-list\剑指 Offer II 077. 链表排序\firstSubmission.ts", "TypeScript", 0, 0, 0, 22, 0, 16, 4, 42
"d:\typescript-algorithms\src\leetcode\linked-list\剑指 Offer II 077. 链表排序\secondSubmission.ts", "TypeScript", 0, 0, 0, 25, 0, 16, 5, 46
"d:\typescript-algorithms\src\leetcode\linked-list\剑指 Offer II 077. 链表排序\simulateSubmission.ts", "TypeScript", 0, 0, 0, 59, 0, 2, 6, 67
"d:\typescript-algorithms\src\leetcode\linked-list\剑指 Offer II 078. 合并排序链表\ListNode.ts", "TypeScript", 0, 0, 0, 8, 0, 0, 1, 9
"d:\typescript-algorithms\src\leetcode\linked-list\剑指 Offer II 078. 合并排序链表\__test__\index.test.ts", "TypeScript", 0, 0, 0, 48, 0, 0, 3, 51
"d:\typescript-algorithms\src\leetcode\linked-list\剑指 Offer II 078. 合并排序链表\finalSubmission.ts", "TypeScript", 0, 0, 0, 27, 0, 12, 5, 44
"d:\typescript-algorithms\src\leetcode\linked-list\剑指 Offer II 078. 合并排序链表\firstSubmission.ts", "TypeScript", 0, 0, 0, 27, 0, 11, 4, 42
"d:\typescript-algorithms\src\leetcode\main\1. Two Sum\firstSubmission.ts", "TypeScript", 0, 0, 0, 11, 0, 0, 2, 13
"d:\typescript-algorithms\src\leetcode\main\101. Symmetric Tree\TreeNode.ts", "TypeScript", 0, 0, 0, 10, 0, 0, 1, 11
"d:\typescript-algorithms\src\leetcode\main\101. Symmetric Tree\finalSubmission.ts", "TypeScript", 0, 0, 0, 19, 0, 0, 3, 22
"d:\typescript-algorithms\src\leetcode\main\101. Symmetric Tree\firstSubmission.ts", "TypeScript", 0, 0, 0, 25, 0, 0, 4, 29
"d:\typescript-algorithms\src\leetcode\main\102. Binary Tree Level Order Traversal\TreeNode.ts", "TypeScript", 0, 0, 0, 10, 0, 0, 1, 11
"d:\typescript-algorithms\src\leetcode\main\102. Binary Tree Level Order Traversal\firstSubmission.ts", "TypeScript", 0, 0, 0, 27, 0, 0, 2, 29
"d:\typescript-algorithms\src\leetcode\main\103. Binary Tree Zigzag Level Order Traversal\TreeNode.ts", "TypeScript", 0, 0, 0, 10, 0, 0, 1, 11
"d:\typescript-algorithms\src\leetcode\main\103. Binary Tree Zigzag Level Order Traversal\firstSubmission.ts", "TypeScript", 0, 0, 0, 33, 0, 0, 2, 35
"d:\typescript-algorithms\src\leetcode\main\104. Maximum Depth of Binary Tree\TreeNode.ts", "TypeScript", 0, 0, 0, 10, 0, 0, 1, 11
"d:\typescript-algorithms\src\leetcode\main\104. Maximum Depth of Binary Tree\firstSubmission.ts", "TypeScript", 0, 0, 0, 12, 0, 0, 3, 15
"d:\typescript-algorithms\src\leetcode\main\105. Construct Binary Tree from Preorder and Inorder Traversal\TreeNode.ts", "TypeScript", 0, 0, 0, 10, 0, 0, 1, 11
"d:\typescript-algorithms\src\leetcode\main\105. Construct Binary Tree from Preorder and Inorder Traversal\firstSubmission.ts", "TypeScript", 0, 0, 0, 19, 0, 0, 3, 22
"d:\typescript-algorithms\src\leetcode\main\11. Container With Most Water\firstSubmission.ts", "TypeScript", 0, 0, 0, 15, 0, 0, 1, 16
"d:\typescript-algorithms\src\leetcode\main\112. Path Sum\TreeNode.ts", "TypeScript", 0, 0, 0, 10, 0, 0, 1, 11
"d:\typescript-algorithms\src\leetcode\main\112. Path Sum\firstSubmission.ts", "TypeScript", 0, 0, 0, 13, 0, 0, 4, 17
"d:\typescript-algorithms\src\leetcode\main\113. Path Sum II\TreeNode.ts", "TypeScript", 0, 0, 0, 10, 0, 0, 1, 11
"d:\typescript-algorithms\src\leetcode\main\113. Path Sum II\firstSubmission.ts", "TypeScript", 0, 0, 0, 20, 0, 0, 5, 25
"d:\typescript-algorithms\src\leetcode\main\114. Flatten Binary Tree to Linked List\TreeNode.ts", "TypeScript", 0, 0, 0, 10, 0, 0, 1, 11
"d:\typescript-algorithms\src\leetcode\main\114. Flatten Binary Tree to Linked List\finalSubmision.ts", "TypeScript", 0, 0, 0, 15, 0, 0, 2, 17
"d:\typescript-algorithms\src\leetcode\main\114. Flatten Binary Tree to Linked List\firstSubmission.ts", "TypeScript", 0, 0, 0, 22, 0, 0, 3, 25
"d:\typescript-algorithms\src\leetcode\main\1143. Longest Common Subsequence\firstSubmission.ts", "TypeScript", 0, 0, 0, 22, 0, 0, 1, 23
"d:\typescript-algorithms\src\leetcode\main\121. Best Time to Buy and Sell Stock\firstSubmission.ts", "TypeScript", 0, 0, 0, 12, 0, 0, 1, 13
"d:\typescript-algorithms\src\leetcode\main\124. Binary Tree Maximum Path Sum\TreeNode.ts", "TypeScript", 0, 0, 0, 10, 0, 0, 1, 11
"d:\typescript-algorithms\src\leetcode\main\124. Binary Tree Maximum Path Sum\firstSubmisison.ts", "TypeScript", 0, 0, 0, 15, 0, 0, 7, 22
"d:\typescript-algorithms\src\leetcode\main\128. Longest Consecutive Sequence\firstSubmission.ts", "TypeScript", 0, 0, 0, 16, 0, 0, 1, 17
"d:\typescript-algorithms\src\leetcode\main\131. Palindrome Partitioning\firstSubmission.ts", "TypeScript", 0, 0, 0, 27, 0, 0, 2, 29
"d:\typescript-algorithms\src\leetcode\main\1343. Number of Sub-arrays of Size K and Average Greater than or Equal to Threshold\firstSubmission.ts", "TypeScript", 0, 0, 0, 23, 0, 0, 1, 24
"d:\typescript-algorithms\src\leetcode\main\136. Single Number\firstSubmission.ts", "TypeScript", 0, 0, 0, 7, 0, 0, 1, 8
"d:\typescript-algorithms\src\leetcode\main\1370. Increasing Decreasing String\firstSubmission.ts", "TypeScript", 0, 0, 0, 23, 0, 0, 1, 24
"d:\typescript-algorithms\src\leetcode\main\1374. Generate a String With Characters That Have Odd Counts\firstSubmission.ts", "TypeScript", 0, 0, 0, 10, 0, 2, 1, 13
"d:\typescript-algorithms\src\leetcode\main\141. Linked List Cycle\ListNode.ts", "TypeScript", 0, 0, 0, 8, 0, 0, 1, 9
"d:\typescript-algorithms\src\leetcode\main\141. Linked List Cycle\firstSubmission.ts", "TypeScript", 0, 0, 0, 17, 0, 0, 2, 19
"d:\typescript-algorithms\src\leetcode\main\142. Linked List Cycle II\ListNode.ts", "TypeScript", 0, 0, 0, 8, 0, 0, 1, 9
"d:\typescript-algorithms\src\leetcode\main\142. Linked List Cycle II\firstSubmission.ts", "TypeScript", 0, 0, 0, 28, 0, 0, 2, 30
"d:\typescript-algorithms\src\leetcode\main\143. Reorder List\ListNode.ts", "TypeScript", 0, 0, 0, 8, 0, 0, 1, 9
"d:\typescript-algorithms\src\leetcode\main\143. Reorder List\firstSubmission.ts", "TypeScript", 0, 0, 0, 21, 0, 0, 2, 23
"d:\typescript-algorithms\src\leetcode\main\144. Binary Tree Preorder Traversal\TreeNode.ts", "TypeScript", 0, 0, 0, 10, 0, 0, 1, 11
"d:\typescript-algorithms\src\leetcode\main\144. Binary Tree Preorder Traversal\finalSubmission.ts", "TypeScript", 0, 0, 0, 19, 0, 0, 2, 21
"d:\typescript-algorithms\src\leetcode\main\144. Binary Tree Preorder Traversal\firstSubmission.ts", "TypeScript", 0, 0, 0, 14, 0, 0, 2, 16
"d:\typescript-algorithms\src\leetcode\main\146. LRU Cache\firstSubmission.ts", "TypeScript", 0, 0, 0, 69, 0, 0, 7, 76
"d:\typescript-algorithms\src\leetcode\main\15. 3Sum\firstSubmission.ts", "TypeScript", 0, 0, 0, 31, 0, 0, 2, 33
"d:\typescript-algorithms\src\leetcode\main\152. Maximum Product Subarray\firstSubmission.ts", "TypeScript", 0, 0, 0, 14, 0, 0, 1, 15
"d:\typescript-algorithms\src\leetcode\main\155. Min Stack\firstSubmission.ts", "TypeScript", 0, 0, 0, 25, 0, 0, 5, 30
"d:\typescript-algorithms\src\leetcode\main\160. Intersection of Two Linked Lists\ListNode.ts", "TypeScript", 0, 0, 0, 8, 0, 0, 1, 9
"d:\typescript-algorithms\src\leetcode\main\160. Intersection of Two Linked Lists\firstSubmission.ts", "TypeScript", 0, 0, 0, 19, 0, 0, 2, 21
"d:\typescript-algorithms\src\leetcode\main\169. Majority Element\firstSubmission.ts", "TypeScript", 0, 0, 0, 15, 0, 0, 1, 16
"d:\typescript-algorithms\src\leetcode\main\17. Letter Combinations of a Phone Number\firstSubmission.ts", "TypeScript", 0, 0, 0, 26, 0, 0, 3, 29
"d:\typescript-algorithms\src\leetcode\main\19. Remove Nth Node From End of List\ListNode.ts", "TypeScript", 0, 0, 0, 8, 0, 0, 1, 9
"d:\typescript-algorithms\src\leetcode\main\19. Remove Nth Node From End of List\firstSubmission.ts", "TypeScript", 0, 0, 0, 19, 0, 0, 2, 21
"d:\typescript-algorithms\src\leetcode\main\199. Binary Tree Right Side View\TreeNode.ts", "TypeScript", 0, 0, 0, 10, 0, 0, 1, 11
"d:\typescript-algorithms\src\leetcode\main\199. Binary Tree Right Side View\firstSubmission.ts", "TypeScript", 0, 0, 0, 27, 0, 0, 3, 30
"d:\typescript-algorithms\src\leetcode\main\20. Valid Parentheses\firstSubmission.ts", "TypeScript", 0, 0, 0, 22, 0, 0, 1, 23
"d:\typescript-algorithms\src\leetcode\main\200. Number of Islands\firstSubmission.ts", "TypeScript", 0, 0, 0, 34, 0, 0, 3, 37
"d:\typescript-algorithms\src\leetcode\main\206. Reverse Linked List\ListNode.ts", "TypeScript", 0, 0, 0, 8, 0, 0, 1, 9
"d:\typescript-algorithms\src\leetcode\main\206. Reverse Linked List\firstSubmission.ts", "TypeScript", 0, 0, 0, 11, 0, 0, 2, 13
"d:\typescript-algorithms\src\leetcode\main\207. Course Schedule\firstSubmission.ts", "TypeScript", 0, 0, 0, 30, 0, 0, 1, 31
"d:\typescript-algorithms\src\leetcode\main\209. Minimum Size Subarray Sum\firstSubmission.ts", "TypeScript", 0, 0, 0, 17, 0, 0, 1, 18
"d:\typescript-algorithms\src\leetcode\main\21. Merge Two Sorted Lists\ListNode.ts", "TypeScript", 0, 0, 0, 8, 0, 0, 1, 9
"d:\typescript-algorithms\src\leetcode\main\21. Merge Two Sorted Lists\firstSubmission.ts", "TypeScript", 0, 0, 0, 20, 0, 0, 2, 22
"d:\typescript-algorithms\src\leetcode\main\22. Generate Parentheses\firstSubmission.ts", "TypeScript", 0, 0, 0, 15, 0, 0, 1, 16
"d:\typescript-algorithms\src\leetcode\main\226. Invert Binary Tree\TreeNode.ts", "TypeScript", 0, 0, 0, 10, 0, 0, 1, 11
"d:\typescript-algorithms\src\leetcode\main\226. Invert Binary Tree\firstSubmission.ts", "TypeScript", 0, 0, 0, 13, 0, 0, 4, 17
"d:\typescript-algorithms\src\leetcode\main\23. Merge k Sorted Lists\ListNode.ts", "TypeScript", 0, 0, 0, 8, 0, 0, 1, 9
"d:\typescript-algorithms\src\leetcode\main\23. Merge k Sorted Lists\firstSubmission.ts", "TypeScript", 0, 0, 0, 40, 0, 0, 3, 43
"d:\typescript-algorithms\src\leetcode\main\234. Palindrome Linked List\ListNode.ts", "TypeScript", 0, 0, 0, 8, 0, 0, 1, 9
"d:\typescript-algorithms\src\leetcode\main\234. Palindrome Linked List\firstSubmission.ts", "TypeScript", 0, 0, 0, 27, 0, 0, 2, 29
"d:\typescript-algorithms\src\leetcode\main\236. Lowest Common Ancestor of a Binary Tree\TreeNode.ts", "TypeScript", 0, 0, 0, 10, 0, 0, 1, 11
"d:\typescript-algorithms\src\leetcode\main\236. Lowest Common Ancestor of a Binary Tree\firstSubmission.ts", "TypeScript", 0, 0, 0, 36, 0, 0, 3, 39
"d:\typescript-algorithms\src\leetcode\main\238. Product of Array Except Self\firstSubmission.ts", "TypeScript", 0, 0, 0, 17, 0, 0, 1, 18
"d:\typescript-algorithms\src\leetcode\main\24. Swap Nodes in Pairs\ListNode.ts", "TypeScript", 0, 0, 0, 8, 0, 0, 1, 9
"d:\typescript-algorithms\src\leetcode\main\24. Swap Nodes in Pairs\firstSubmission.ts", "TypeScript", 0, 0, 0, 20, 0, 0, 2, 22
"d:\typescript-algorithms\src\leetcode\main\240. Search a 2D Matrix II\firstSubmission.ts", "TypeScript", 0, 0, 0, 16, 0, 0, 1, 17
"d:\typescript-algorithms\src\leetcode\main\25. Reverse Nodes in k-Group\ListNode.ts", "TypeScript", 0, 0, 0, 8, 0, 0, 1, 9
"d:\typescript-algorithms\src\leetcode\main\25. Reverse Nodes in k-Group\finalSubmission.ts", "TypeScript", 0, 0, 0, 38, 0, 0, 3, 41
"d:\typescript-algorithms\src\leetcode\main\25. Reverse Nodes in k-Group\firstSubmission.ts", "TypeScript", 0, 0, 0, 33, 0, 0, 2, 35
"d:\typescript-algorithms\src\leetcode\main\25. Reverse Nodes in k-Group\secondSubmission.ts", "TypeScript", 0, 0, 0, 23, 0, 0, 2, 25
"d:\typescript-algorithms\src\leetcode\main\283. Move Zeroes\firstSubmission.ts", "TypeScript", 0, 0, 0, 10, 0, 1, 1, 12
"d:\typescript-algorithms\src\leetcode\main\283. Move Zeroes\secondSubmission.ts", "TypeScript", 0, 0, 0, 13, 0, 0, 1, 14
"d:\typescript-algorithms\src\leetcode\main\287. Find the Duplicate Number\finalSubmission.ts", "TypeScript", 0, 0, 0, 19, 0, 0, 1, 20
"d:\typescript-algorithms\src\leetcode\main\287. Find the Duplicate Number\firstSubmission.ts", "TypeScript", 0, 0, 0, 14, 0, 0, 1, 15
"d:\typescript-algorithms\src\leetcode\main\3. Longest Substring Without Repeating Characters\firstSubmission.ts", "TypeScript", 0, 0, 0, 29, 0, 0, 1, 30
"d:\typescript-algorithms\src\leetcode\main\300. Longest Increasing Subsequence\firstSubmission.ts", "TypeScript", 0, 0, 0, 16, 0, 0, 1, 17
"d:\typescript-algorithms\src\leetcode\main\31. Next Permutation\firstSubmission.ts", "TypeScript", 0, 0, 0, 23, 0, 2, 1, 26
"d:\typescript-algorithms\src\leetcode\main\32. Longest Valid Parentheses\firstSubmission.ts", "TypeScript", 0, 0, 0, 18, 0, 0, 1, 19
"d:\typescript-algorithms\src\leetcode\main\33. Search in Rotated Sorted Array\firstSubmission.ts", "TypeScript", 0, 0, 0, 24, 0, 2, 1, 27
"d:\typescript-algorithms\src\leetcode\main\337. House Robber III\TreeNode.ts", "TypeScript", 0, 0, 0, 10, 0, 0, 1, 11
"d:\typescript-algorithms\src\leetcode\main\337. House Robber III\firstSubmission.ts", "TypeScript", 0, 0, 0, 20, 0, 3, 4, 27
"d:\typescript-algorithms\src\leetcode\main\34. Find First and Last Position of Element in Sorted Array\firstSubmission.ts", "TypeScript", 0, 0, 0, 24, 0, 0, 2, 26
"d:\typescript-algorithms\src\leetcode\main\39. Combination Sum\firstSubmission.ts", "TypeScript", 0, 0, 0, 21, 0, 0, 3, 24
"d:\typescript-algorithms\src\leetcode\main\394. Decode String\firstSubmission.ts", "TypeScript", 0, 0, 0, 33, 0, 0, 2, 35
"d:\typescript-algorithms\src\leetcode\main\4. Median of Two Sorted Arrays\firstSubmission.ts", "TypeScript", 0, 0, 0, 41, 0, 1, 1, 43
"d:\typescript-algorithms\src\leetcode\main\40. Combination Sum II\firstSubmission.ts", "TypeScript", 0, 0, 0, 27, 0, 0, 1, 28
"d:\typescript-algorithms\src\leetcode\main\406. Queue Reconstruction by Height\firstSubmission.ts", "TypeScript", 0, 0, 0, 14, 0, 0, 2, 16
"d:\typescript-algorithms\src\leetcode\main\41. First Missing Positive\finalSubmission.ts", "TypeScript", 0, 0, 0, 14, 0, 0, 1, 15
"d:\typescript-algorithms\src\leetcode\main\41. First Missing Positive\firstSubmission.ts", "TypeScript", 0, 0, 0, 15, 0, 0, 1, 16
"d:\typescript-algorithms\src\leetcode\main\415. Add Strings\firstSubmission.ts", "TypeScript", 0, 0, 0, 44, 0, 0, 1, 45
"d:\typescript-algorithms\src\leetcode\main\42. Trapping Rain Water\firstSubmission.ts", "TypeScript", 0, 0, 0, 18, 0, 0, 4, 22
"d:\typescript-algorithms\src\leetcode\main\437. Path Sum III\TreeNode.ts", "TypeScript", 0, 0, 0, 10, 0, 0, 1, 11
"d:\typescript-algorithms\src\leetcode\main\437. Path Sum III\firstSubmission.ts", "TypeScript", 0, 0, 0, 22, 0, 0, 4, 26
"d:\typescript-algorithms\src\leetcode\main\438. Find All Anagrams in a String\firstSubmission.ts", "TypeScript", 0, 0, 0, 44, 0, 0, 1, 45
"d:\typescript-algorithms\src\leetcode\main\448. Find All Numbers Disappeared in an Array\firstSubmission.ts", "TypeScript", 0, 0, 0, 13, 0, 0, 3, 16
"d:\typescript-algorithms\src\leetcode\main\459. Repeated Substring Pattern\firstSubmission.ts", "TypeScript", 0, 0, 0, 3, 0, 0, 1, 4
"d:\typescript-algorithms\src\leetcode\main\46. Permutations\firstSubmission.ts", "TypeScript", 0, 0, 0, 16, 0, 0, 3, 19
"d:\typescript-algorithms\src\leetcode\main\468. Validate IP Address\firstSubmission.ts", "TypeScript", 0, 0, 0, 16, 0, 0, 3, 19
"d:\typescript-algorithms\src\leetcode\main\47. Permutations II\firstSubmission.ts", "TypeScript", 0, 0, 0, 23, 0, 0, 2, 25
"d:\typescript-algorithms\src\leetcode\main\48. Rotate Image\finalSubmission.ts", "TypeScript", 0, 0, 0, 9, 0, 0, 1, 10
"d:\typescript-algorithms\src\leetcode\main\48. Rotate Image\firstSubmission.ts", "TypeScript", 0, 0, 0, 12, 0, 0, 1, 13
"d:\typescript-algorithms\src\leetcode\main\49. Group Anagrams\firstSubmission.ts", "TypeScript", 0, 0, 0, 12, 0, 0, 1, 13
"d:\typescript-algorithms\src\leetcode\main\538. Convert BST to Greater Tree\TreeNode.ts", "TypeScript", 0, 0, 0, 10, 0, 0, 1, 11
"d:\typescript-algorithms\src\leetcode\main\538. Convert BST to Greater Tree\firstSubmission.ts", "TypeScript", 0, 0, 0, 15, 0, 0, 4, 19
"d:\typescript-algorithms\src\leetcode\main\54. Spiral Matrix\firstSubmission.ts", "TypeScript", 0, 0, 0, 37, 0, 0, 1, 38
"d:\typescript-algorithms\src\leetcode\main\543. Diameter of Binary Tree\TreeNode.ts", "TypeScript", 0, 0, 0, 10, 0, 0, 1, 11
"d:\typescript-algorithms\src\leetcode\main\543. Diameter of Binary Tree\firstSubmisison.ts", "TypeScript", 0, 0, 0, 15, 0, 0, 3, 18
"d:\typescript-algorithms\src\leetcode\main\55. Jump Game\firstSubmission.ts", "TypeScript", 0, 0, 0, 10, 0, 0, 1, 11
"d:\typescript-algorithms\src\leetcode\main\56. Merge Intervals\firstSubmission.ts", "TypeScript", 0, 0, 0, 13, 0, 0, 1, 14
"d:\typescript-algorithms\src\leetcode\main\560. Subarray Sum Equals K\firstSubmission.ts", "TypeScript", 0, 0, 0, 18, 0, 1, 1, 20
"d:\typescript-algorithms\src\leetcode\main\581. Shortest Unsorted Continuous Subarray\firstSubmission.ts", "TypeScript", 0, 0, 0, 22, 0, 0, 1, 23
"d:\typescript-algorithms\src\leetcode\main\6. ZigZag Conversion\firstSubmission.ts", "TypeScript", 0, 0, 0, 23, 0, 0, 1, 24
"d:\typescript-algorithms\src\leetcode\main\617. Merge Two Binary Trees\TreeNode.ts", "TypeScript", 0, 0, 0, 10, 0, 0, 1, 11
"d:\typescript-algorithms\src\leetcode\main\617. Merge Two Binary Trees\firstSubmission.ts", "TypeScript", 0, 0, 0, 16, 0, 0, 2, 18
"d:\typescript-algorithms\src\leetcode\main\62. Unique Paths\firstSubmission.ts", "TypeScript", 0, 0, 0, 15, 0, 0, 1, 16
"d:\typescript-algorithms\src\leetcode\main\63. Unique Paths II\firstSubmission.ts", "TypeScript", 0, 0, 0, 26, 0, 0, 1, 27
"d:\typescript-algorithms\src\leetcode\main\67. Add Binary\firstSubmission.ts", "TypeScript", 0, 0, 0, 26, 0, 0, 1, 27
"d:\typescript-algorithms\src\leetcode\main\674. Longest Continuous Increasing Subsequence\firstSubmission.ts", "TypeScript", 0, 0, 0, 14, 0, 0, 1, 15
"d:\typescript-algorithms\src\leetcode\main\695. Max Area of Island\firstSubmission.ts", "TypeScript", 0, 0, 0, 37, 0, 0, 3, 40
"d:\typescript-algorithms\src\leetcode\main\7. Reverse Integer\finalSubmission.ts", "TypeScript", 0, 0, 0, 18, 0, 1, 1, 20
"d:\typescript-algorithms\src\leetcode\main\7. Reverse Integer\firstSubmission.ts", "TypeScript", 0, 0, 0, 13, 0, 0, 1, 14
"d:\typescript-algorithms\src\leetcode\main\72. Edit Distance\firstSubmission.ts", "TypeScript", 0, 0, 0, 24, 0, 0, 3, 27
"d:\typescript-algorithms\src\leetcode\main\739. Daily Temperatures\firstSubmission.ts", "TypeScript", 0, 0, 0, 19, 0, 0, 1, 20
"d:\typescript-algorithms\src\leetcode\main\75. Sort Colors\finalSubmission.ts", "TypeScript", 0, 0, 0, 17, 0, 0, 1, 18
"d:\typescript-algorithms\src\leetcode\main\75. Sort Colors\firstSubmission.ts", "TypeScript", 0, 0, 0, 16, 0, 0, 1, 17
"d:\typescript-algorithms\src\leetcode\main\76. Minimum Window Substring\firstSubmission.ts", "TypeScript", 0, 0, 0, 45, 0, 0, 1, 46
"d:\typescript-algorithms\src\leetcode\main\779. K-th Symbol in Grammar\firstSubmission.ts", "TypeScript", 0, 0, 0, 10, 0, 1, 1, 12
"d:\typescript-algorithms\src\leetcode\main\78. Subsets\firstSubmission.ts", "TypeScript", 0, 0, 0, 13, 0, 0, 1, 14
"d:\typescript-algorithms\src\leetcode\main\79. Word Search\firstSubmission.ts", "TypeScript", 0, 0, 0, 45, 0, 0, 4, 49
"d:\typescript-algorithms\src\leetcode\main\84. Largest Rectangle in Histogram\firstSubmission.ts", "TypeScript", 0, 0, 0, 26, 0, 0, 1, 27
"d:\typescript-algorithms\src\leetcode\main\859. Buddy Strings\firstSubmission.ts", "TypeScript", 0, 0, 0, 28, 0, 0, 1, 29
"d:\typescript-algorithms\src\leetcode\main\88. Merge Sorted Array\firstSubmission.ts", "TypeScript", 0, 0, 0, 21, 0, 0, 1, 22
"d:\typescript-algorithms\src\leetcode\main\90. Subsets II\firstSubmission.ts", "TypeScript", 0, 0, 0, 33, 0, 1, 1, 35
"d:\typescript-algorithms\src\leetcode\main\92. Reverse Linked List II\ListNode.ts", "TypeScript", 0, 0, 0, 8, 0, 0, 1, 9
"d:\typescript-algorithms\src\leetcode\main\92. Reverse Linked List II\firstSubmission.ts", "TypeScript", 0, 0, 0, 26, 0, 0, 2, 28
"d:\typescript-algorithms\src\leetcode\main\93. Restore IP Addresses\firstSubmission.ts", "TypeScript", 0, 0, 0, 28, 0, 0, 3, 31
"d:\typescript-algorithms\src\leetcode\main\938. Range Sum of BST\TreeNode.ts", "TypeScript", 0, 0, 0, 10, 0, 0, 1, 11
"d:\typescript-algorithms\src\leetcode\main\938. Range Sum of BST\finalSubmission.ts", "TypeScript", 0, 0, 0, 21, 0, 0, 2, 23
"d:\typescript-algorithms\src\leetcode\main\938. Range Sum of BST\firstSubmission.ts", "TypeScript", 0, 0, 0, 28, 0, 0, 2, 30
"d:\typescript-algorithms\src\leetcode\main\94. Binary Tree Inorder Traversal\TreeNode.ts", "TypeScript", 0, 0, 0, 10, 0, 0, 1, 11
"d:\typescript-algorithms\src\leetcode\main\94. Binary Tree Inorder Traversal\finalSubmission.ts", "TypeScript", 0, 0, 0, 14, 0, 0, 2, 16
"d:\typescript-algorithms\src\leetcode\main\94. Binary Tree Inorder Traversal\firstSubmission.ts", "TypeScript", 0, 0, 0, 15, 0, 0, 2, 17
"d:\typescript-algorithms\src\leetcode\main\96. Unique Binary Search Trees\firstSubmission.ts", "TypeScript", 0, 0, 0, 13, 0, 0, 1, 14
"d:\typescript-algorithms\src\leetcode\main\98. Validate Binary Search Tree\TreeNode.ts", "TypeScript", 0, 0, 0, 10, 0, 0, 1, 11
"d:\typescript-algorithms\src\leetcode\main\98. Validate Binary Search Tree\firstSubmission.ts", "TypeScript", 0, 0, 0, 18, 0, 0, 2, 20
"d:\typescript-algorithms\src\leetcode\main\剑指 Offer 03. 数组中重复的数字\firstSubmission.ts", "TypeScript", 0, 0, 0, 10, 0, 0, 1, 11
"d:\typescript-algorithms\src\leetcode\main\剑指 Offer 55 - II. 平衡二叉树\TreeNode.ts", "TypeScript", 0, 0, 0, 10, 0, 0, 1, 11
"d:\typescript-algorithms\src\leetcode\main\剑指 Offer 55 - II. 平衡二叉树\firstSubmission.ts", "TypeScript", 0, 0, 0, 22, 0, 0, 7, 29
"d:\typescript-algorithms\src\leetcode\main\面试题 01.06. Compress String LCCI\firstSubmission.ts", "TypeScript", 0, 0, 0, 15, 0, 1, 1, 17
"d:\typescript-algorithms\src\leetcode\main\面试题 16.26. Calculator LCCI\firstSubmission.ts", "TypeScript", 0, 0, 0, 39, 0, 0, 1, 40
"d:\typescript-algorithms\src\leetcode\top\1. Two Sum\firstSubmission.ts", "TypeScript", 0, 0, 0, 11, 0, 0, 1, 12
"d:\typescript-algorithms\src\leetcode\top\10. Regular Expression Matching\firstSubmission.ts", "TypeScript", 0, 0, 0, 3, 0, 0, 1, 4
"d:\typescript-algorithms\src\leetcode\top\101. Symmetric Tree\TreeNode.ts", "TypeScript", 0, 0, 0, 10, 0, 0, 1, 11
"d:\typescript-algorithms\src\leetcode\top\101. Symmetric Tree\firstSubmission.ts", "TypeScript", 0, 0, 0, 27, 0, 0, 9, 36
"d:\typescript-algorithms\src\leetcode\top\102. Binary Tree Level Order Traversal\TreeNode.ts", "TypeScript", 0, 0, 0, 10, 0, 0, 1, 11
"d:\typescript-algorithms\src\leetcode\top\102. Binary Tree Level Order Traversal\firstSubmission.ts", "TypeScript", 0, 0, 0, 27, 0, 0, 4, 31
"d:\typescript-algorithms\src\leetcode\top\103. Binary Tree Zigzag Level Order Traversal\TreeNode.ts", "TypeScript", 0, 0, 0, 10, 0, 0, 1, 11
"d:\typescript-algorithms\src\leetcode\top\103. Binary Tree Zigzag Level Order Traversal\firstSubmission.ts", "TypeScript", 0, 0, 0, 33, 0, 0, 3, 36
"d:\typescript-algorithms\src\leetcode\top\104. Maximum Depth of Binary Tree\TreeNode.ts", "TypeScript", 0, 0, 0, 10, 0, 0, 1, 11
"d:\typescript-algorithms\src\leetcode\top\104. Maximum Depth of Binary Tree\firstSubmission.ts", "TypeScript", 0, 0, 0, 12, 0, 0, 5, 17
"d:\typescript-algorithms\src\leetcode\top\104. Maximum Depth of Binary Tree\secondSubmission.ts", "TypeScript", 0, 0, 0, 24, 0, 0, 2, 26
"d:\typescript-algorithms\src\leetcode\top\105. Construct Binary Tree from Preorder and Inorder Traversal\TreeNode.ts", "TypeScript", 0, 0, 0, 10, 0, 0, 1, 11
"d:\typescript-algorithms\src\leetcode\top\105. Construct Binary Tree from Preorder and Inorder Traversal\firstSubmission.ts", "TypeScript", 0, 0, 0, 28, 0, 1, 3, 32
"d:\typescript-algorithms\src\leetcode\top\108. Convert Sorted Array to Binary Search Tree\TreeNode.ts", "TypeScript", 0, 0, 0, 10, 0, 0, 1, 11
"d:\typescript-algorithms\src\leetcode\top\108. Convert Sorted Array to Binary Search Tree\firstSubmission.ts", "TypeScript", 0, 0, 0, 14, 0, 0, 4, 18
"d:\typescript-algorithms\src\leetcode\top\11. Container With Most Water\firstSubmission.ts", "TypeScript", 0, 0, 0, 15, 0, 0, 1, 16
"d:\typescript-algorithms\src\leetcode\top\116. Populating Next Right Pointers in Each Node\Node.ts", "TypeScript", 0, 0, 0, 17, 0, 0, 1, 18
"d:\typescript-algorithms\src\leetcode\top\116. Populating Next Right Pointers in Each Node\finalSubmission.ts", "TypeScript", 0, 0, 0, 9, 0, 0, 2, 11
"d:\typescript-algorithms\src\leetcode\top\116. Populating Next Right Pointers in Each Node\firstSubmission.ts", "TypeScript", 0, 0, 0, 25, 0, 0, 6, 31
"d:\typescript-algorithms\src\leetcode\top\118. Pascal's Triangle\firstSubmission.ts", "TypeScript", 0, 0, 0, 16, 0, 0, 2, 18
"d:\typescript-algorithms\src\leetcode\top\121. Best Time to Buy and Sell Stock\firstSubmission.ts", "TypeScript", 0, 0, 0, 12, 0, 0, 1, 13
"d:\typescript-algorithms\src\leetcode\top\122. Best Time to Buy and Sell Stock II\finalSubmission.ts", "TypeScript", 0, 0, 0, 9, 0, 0, 1, 10
"d:\typescript-algorithms\src\leetcode\top\122. Best Time to Buy and Sell Stock II\firstSubmission.ts", "TypeScript", 0, 0, 0, 11, 0, 5, 1, 17
"d:\typescript-algorithms\src\leetcode\top\124. Binary Tree Maximum Path Sum\TreeNode.ts", "TypeScript", 0, 0, 0, 10, 0, 0, 1, 11
"d:\typescript-algorithms\src\leetcode\top\124. Binary Tree Maximum Path Sum\firstSubmission.ts", "TypeScript", 0, 0, 0, 18, 0, 2, 6, 26
"d:\typescript-algorithms\src\leetcode\top\125. Valid Palindrome\firstSubmission.ts", "TypeScript", 0, 0, 0, 25, 0, 1, 2, 28
"d:\typescript-algorithms\src\leetcode\top\127. Word Ladder\firstSubmission.ts", "TypeScript", 0, 0, 0, 23, 0, 1, 2, 26
"d:\typescript-algorithms\src\leetcode\top\128. Longest Consecutive Sequence\firstSubmission.ts", "TypeScript", 0, 0, 0, 17, 0, 0, 1, 18
"d:\typescript-algorithms\src\leetcode\top\128. Longest Consecutive Sequence\secondSubmission.ts", "TypeScript", 0, 0, 0, 40, 0, 0, 7, 47
"d:\typescript-algorithms\src\leetcode\top\13. Roman to Integer\finalSubmission.ts", "TypeScript", 0, 0, 0, 21, 0, 1, 1, 23
"d:\typescript-algorithms\src\leetcode\top\13. Roman to Integer\firstSubmission.ts", "TypeScript", 0, 0, 0, 45, 0, 1, 2, 48
"d:\typescript-algorithms\src\leetcode\top\130. Surrounded Regions\__test__\index.test.ts", "TypeScript", 0, 0, 0, 18, 0, 0, 2, 20
"d:\typescript-algorithms\src\leetcode\top\130. Surrounded Regions\firstSubmission.ts", "TypeScript", 0, 0, 0, 32, 0, 4, 5, 41
"d:\typescript-algorithms\src\leetcode\top\131. Palindrome Partitioning\finalSubmisison.ts", "TypeScript", 0, 0, 0, 28, 0, 0, 1, 29
"d:\typescript-algorithms\src\leetcode\top\131. Palindrome Partitioning\firstSubmission.ts", "TypeScript", 0, 0, 0, 20, 0, 0, 5, 25
"d:\typescript-algorithms\src\leetcode\top\134. Gas Station\finalSubmission.ts", "TypeScript", 0, 0, 0, 24, 0, 2, 1, 27
"d:\typescript-algorithms\src\leetcode\top\134. Gas Station\firstSubmission.ts", "TypeScript", 0, 0, 0, 24, 0, 0, 1, 25
"d:\typescript-algorithms\src\leetcode\top\136. Single Number\firstSubmission.ts", "TypeScript", 0, 0, 0, 7, 0, 0, 1, 8
"d:\typescript-algorithms\src\leetcode\top\138. Copy List with Random Pointer\ListNode.ts", "TypeScript", 0, 0, 0, 10, 0, 0, 1, 11
"d:\typescript-algorithms\src\leetcode\top\138. Copy List with Random Pointer\firstSubmission.ts", "TypeScript", 0, 0, 0, 18, 0, 1, 2, 21
"d:\typescript-algorithms\src\leetcode\top\139. Word Break\firstSubmission.ts", "TypeScript", 0, 0, 0, 21, 0, 0, 1, 22
"d:\typescript-algorithms\src\leetcode\top\14. Longest Common Prefix\firstSubmission.ts", "TypeScript", 0, 0, 0, 24, 0, 0, 1, 25
"d:\typescript-algorithms\src\leetcode\top\140. Word Break II\firstSubmission.ts", "TypeScript", 0, 0, 0, 14, 0, 3, 2, 19
"d:\typescript-algorithms\src\leetcode\top\141. Linked List Cycle\ListNode.ts", "TypeScript", 0, 0, 0, 8, 0, 0, 1, 9
"d:\typescript-algorithms\src\leetcode\top\141. Linked List Cycle\finalSubmission.ts", "TypeScript", 0, 0, 0, 12, 0, 0, 2, 14
"d:\typescript-algorithms\src\leetcode\top\141. Linked List Cycle\firstSubmission.ts", "TypeScript", 0, 0, 0, 20, 0, 0, 2, 22
"d:\typescript-algorithms\src\leetcode\top\146. LRU Cache\firstSubmission.ts", "TypeScript", 0, 0, 0, 73, 0, 0, 8, 81
"d:\typescript-algorithms\src\leetcode\top\148. Sort List\ListNode.ts", "TypeScript", 0, 0, 0, 8, 0, 0, 1, 9
"d:\typescript-algorithms\src\leetcode\top\148. Sort List\finalSubmission.ts", "TypeScript", 0, 0, 0, 59, 0, 0, 7, 66
"d:\typescript-algorithms\src\leetcode\top\148. Sort List\firstSubmission.ts", "TypeScript", 0, 0, 0, 17, 0, 11, 3, 31
"d:\typescript-algorithms\src\leetcode\top\149. Max Points on a Line\firstSubmission.ts", "TypeScript", 0, 0, 0, 23, 0, 0, 1, 24
"d:\typescript-algorithms\src\leetcode\top\15. 3Sum\firstSubmission.ts", "TypeScript", 0, 0, 0, 32, 0, 1, 1, 34
"d:\typescript-algorithms\src\leetcode\top\150. Evaluate Reverse Polish Notation\firstSubmission.ts", "TypeScript", 0, 0, 0, 24, 0, 0, 2, 26
"d:\typescript-algorithms\src\leetcode\top\152. Maximum Product Subarray\firstSubmission.ts", "TypeScript", 0, 0, 0, 13, 0, 0, 1, 14
"d:\typescript-algorithms\src\leetcode\top\155. Min Stack\firstSubmission.ts", "TypeScript", 0, 0, 0, 26, 0, 0, 5, 31
"d:\typescript-algorithms\src\leetcode\top\160. Intersection of Two Linked Lists\ListNode.ts", "TypeScript", 0, 0, 0, 8, 0, 0, 1, 9
"d:\typescript-algorithms\src\leetcode\top\160. Intersection of Two Linked Lists\firstSubmission.ts", "TypeScript", 0, 0, 0, 16, 0, 0, 2, 18
"d:\typescript-algorithms\src\leetcode\top\162. Find Peak Element\finalSubmission.ts", "TypeScript", 0, 0, 0, 13, 0, 0, 1, 14
"d:\typescript-algorithms\src\leetcode\top\162. Find Peak Element\firstSubmission.ts", "TypeScript", 0, 0, 0, 10, 0, 0, 1, 11
"d:\typescript-algorithms\src\leetcode\top\166. Fraction to Recurring Decimal\firstSubmission.ts", "TypeScript", 0, 0, 0, 34, 0, 0, 3, 37
"d:\typescript-algorithms\src\leetcode\top\169. Majority Element\firstSubmission.ts", "TypeScript", 0, 0, 0, 15, 0, 0, 1, 16
"d:\typescript-algorithms\src\leetcode\top\17. Letter Combinations of a Phone Number\firstSubmission.ts", "TypeScript", 0, 0, 0, 27, 0, 0, 1, 28
"d:\typescript-algorithms\src\leetcode\top\171. Excel Sheet Column Number'\firstSubmission.ts", "TypeScript", 0, 0, 0, 11, 0, 0, 1, 12
"d:\typescript-algorithms\src\leetcode\top\172. Factorial Trailing Zeroes\firstSubmission.ts", "TypeScript", 0, 0, 0, 8, 0, 4, 1, 13
"d:\typescript-algorithms\src\leetcode\top\179. Largest Number\firstSubmission.ts", "TypeScript", 0, 0, 0, 15, 0, 0, 3, 18
"d:\typescript-algorithms\src\leetcode\top\189. Rotate Array\finalSubmission.ts", "TypeScript", 0, 0, 0, 15, 0, 0, 2, 17
"d:\typescript-algorithms\src\leetcode\top\189. Rotate Array\firstSubmission.ts", "TypeScript", 0, 0, 0, 5, 0, 0, 1, 6
"d:\typescript-algorithms\src\leetcode\top\189. Rotate Array\secondSubmission.ts", "TypeScript", 0, 0, 0, 10, 0, 0, 1, 11
"d:\typescript-algorithms\src\leetcode\top\19. Remove Nth Node From End of List\ListNode.ts", "TypeScript", 0, 0, 0, 10, 0, 0, 1, 11
"d:\typescript-algorithms\src\leetcode\top\19. Remove Nth Node From End of List\firstSubmission.ts", "TypeScript", 0, 0, 0, 22, 0, 0, 2, 24
"d:\typescript-algorithms\src\leetcode\top\190. Reverse Bits\firstSubmission.ts", "TypeScript", 0, 0, 0, 11, 0, 1, 1, 13
"d:\typescript-algorithms\src\leetcode\top\190. Reverse Bits\secondSubmission.ts", "TypeScript", 0, 0, 0, 5, 0, 0, 1, 6
"d:\typescript-algorithms\src\leetcode\top\191. Number of 1 Bits\firstSubmission.ts", "TypeScript", 0, 0, 0, 8, 0, 0, 1, 9
"d:\typescript-algorithms\src\leetcode\top\198. House Robber\firstSubmission.ts", "TypeScript", 0, 0, 0, 13, 0, 0, 1, 14
"d:\typescript-algorithms\src\leetcode\top\2. Add Two Numbers\ListNode.ts", "TypeScript", 0, 0, 0, 10, 0, 0, 1, 11
"d:\typescript-algorithms\src\leetcode\top\2. Add Two Numbers\firstSubmission.ts", "TypeScript", 0, 0, 0, 54, 0, 11, 3, 68
"d:\typescript-algorithms\src\leetcode\top\20. Valid Parentheses\firstSubmission.ts", "TypeScript", 0, 0, 0, 21, 0, 0, 1, 22
"d:\typescript-algorithms\src\leetcode\top\200. Number of Islands\finalSubmission.ts", "TypeScript", 0, 0, 0, 70, 0, 0, 9, 79
"d:\typescript-algorithms\src\leetcode\top\200. Number of Islands\firstSubmission.ts", "TypeScript", 0, 0, 0, 29, 0, 0, 4, 33
"d:\typescript-algorithms\src\leetcode\top\202. Happy Number\firstSubmission.ts", "TypeScript", 0, 0, 0, 13, 0, 0, 1, 14
"d:\typescript-algorithms\src\leetcode\top\204. Count Primes\finalSubmission.ts", "TypeScript", 0, 0, 0, 13, 0, 0, 1, 14
"d:\typescript-algorithms\src\leetcode\top\204. Count Primes\firstSubmission.ts", "TypeScript", 0, 0, 0, 15, 0, 0, 2, 17
"d:\typescript-algorithms\src\leetcode\top\206. Reverse Linked List\ListNode.ts", "TypeScript", 0, 0, 0, 8, 0, 0, 1, 9
"d:\typescript-algorithms\src\leetcode\top\206. Reverse Linked List\firstSubmisison.ts", "TypeScript", 0, 0, 0, 11, 0, 0, 2, 13
"d:\typescript-algorithms\src\leetcode\top\207. Course Schedule\firstSubmission.ts", "TypeScript", 0, 0, 0, 33, 0, 0, 1, 34
"d:\typescript-algorithms\src\leetcode\top\208. Implement Trie (Prefix Tree)\firstSubmission.ts", "TypeScript", 0, 0, 0, 34, 0, 0, 5, 39
"d:\typescript-algorithms\src\leetcode\top\21. Merge Two Sorted Lists\ListNode.ts", "TypeScript", 0, 0, 0, 10, 0, 0, 1, 11
"d:\typescript-algorithms\src\leetcode\top\21. Merge Two Sorted Lists\firstSubmission.ts", "TypeScript", 0, 0, 0, 20, 0, 0, 2, 22
"d:\typescript-algorithms\src\leetcode\top\210. Course Schedule II\firstSubmission.ts", "TypeScript", 0, 0, 0, 39, 0, 0, 1, 40
"d:\typescript-algorithms\src\leetcode\top\212. Word Search II\firstSubmission.ts", "TypeScript", 0, 0, 0, 47, 0, 0, 6, 53
"d:\typescript-algorithms\src\leetcode\top\215. Kth Largest Element in an Array\finalSubmission.ts", "TypeScript", 0, 0, 0, 67, 0, 0, 6, 73
"d:\typescript-algorithms\src\leetcode\top\215. Kth Largest Element in an Array\firstSubmission.ts", "TypeScript", 0, 0, 0, 31, 0, 0, 2, 33
"d:\typescript-algorithms\src\leetcode\top\217. Contains Duplicate\firstSubmission.ts", "TypeScript", 0, 0, 0, 10, 0, 0, 1, 11
"d:\typescript-algorithms\src\leetcode\top\22. Generate Parentheses\firstSubmission.ts", "TypeScript", 0, 0, 0, 17, 0, 0, 1, 18
"d:\typescript-algorithms\src\leetcode\top\227. Basic Calculator II\firstSubmission.ts", "TypeScript", 0, 0, 0, 34, 0, 0, 1, 35
"d:\typescript-algorithms\src\leetcode\top\23. Merge k Sorted Lists\ListNode.ts", "TypeScript", 0, 0, 0, 10, 0, 0, 1, 11
"d:\typescript-algorithms\src\leetcode\top\23. Merge k Sorted Lists\firstSubmission.ts", "TypeScript", 0, 0, 0, 69, 0, 12, 8, 89
"d:\typescript-algorithms\src\leetcode\top\230. Kth Smallest Element in a BST\TreeNode.ts", "TypeScript", 0, 0, 0, 10, 0, 0, 1, 11
"d:\typescript-algorithms\src\leetcode\top\230. Kth Smallest Element in a BST\finalSubmission.ts", "TypeScript", 0, 0, 0, 43, 0, 0, 6, 49
"d:\typescript-algorithms\src\leetcode\top\230. Kth Smallest Element in a BST\firstSubmission.ts", "TypeScript", 0, 0, 0, 21, 0, 0, 3, 24
"d:\typescript-algorithms\src\leetcode\top\234. Palindrome Linked List\ListNode.ts", "TypeScript", 0, 0, 0, 8, 0, 0, 1, 9
"d:\typescript-algorithms\src\leetcode\top\234. Palindrome Linked List\firstSubmission.ts", "TypeScript", 0, 0, 0, 31, 0, 0, 2, 33
"d:\typescript-algorithms\src\leetcode\top\236. Lowest Common Ancestor of a Binary Tree\TreeNode.ts", "TypeScript", 0, 0, 0, 10, 0, 0, 1, 11
"d:\typescript-algorithms\src\leetcode\top\236. Lowest Common Ancestor of a Binary Tree\firstSubmission.ts", "TypeScript", 0, 0, 0, 40, 0, 0, 2, 42
"d:\typescript-algorithms\src\leetcode\top\237. Delete Node in a Linked List\ListNode.ts", "TypeScript", 0, 0, 0, 8, 0, 0, 1, 9
"d:\typescript-algorithms\src\leetcode\top\237. Delete Node in a Linked List\finalSubmission.ts", "TypeScript", 0, 0, 0, 5, 0, 0, 2, 7
"d:\typescript-algorithms\src\leetcode\top\237. Delete Node in a Linked List\firstSubmission.ts", "TypeScript", 0, 0, 0, 11, 0, 0, 2, 13
"d:\typescript-algorithms\src\leetcode\top\238. Product of Array Except Self\firstSubmission.ts", "TypeScript", 0, 0, 0, 16, 0, 0, 1, 17
"d:\typescript-algorithms\src\leetcode\top\239. Sliding Window Maximum\firstSubmission.ts", "TypeScript", 0, 0, 0, 25, 0, 0, 3, 28
"d:\typescript-algorithms\src\leetcode\top\240. Search a 2D Matrix II\firstSubmission.ts", "TypeScript", 0, 0, 0, 16, 0, 0, 4, 20
"d:\typescript-algorithms\src\leetcode\top\242. Valid Anagram\firstSubmission.ts", "TypeScript", 0, 0, 0, 3, 0, 0, 1, 4
"d:\typescript-algorithms\src\leetcode\top\242. Valid Anagram\secondSubmission.ts", "TypeScript", 0, 0, 0, 23, 0, 0, 2, 25
"d:\typescript-algorithms\src\leetcode\top\26. Remove Duplicates from Sorted Array\firstSubmission.ts", "TypeScript", 0, 0, 0, 12, 0, 0, 1, 13
"d:\typescript-algorithms\src\leetcode\top\268. Missing Number\finalSubmission.ts", "TypeScript", 0, 0, 0, 5, 0, 0, 1, 6
"d:\typescript-algorithms\src\leetcode\top\268. Missing Number\firstSubmission.ts", "TypeScript", 0, 0, 0, 10, 0, 0, 2, 12
"d:\typescript-algorithms\src\leetcode\top\279. Perfect Squares\firstSubmission.ts", "TypeScript", 0, 0, 0, 11, 0, 0, 1, 12
"d:\typescript-algorithms\src\leetcode\top\28. Implement strStr()\firstSubmission.ts", "TypeScript", 0, 0, 0, 21, 0, 0, 1, 22
"d:\typescript-algorithms\src\leetcode\top\283. Move Zeroes\firstSubmission.ts", "TypeScript", 0, 0, 0, 12, 0, 0, 1, 13
"d:\typescript-algorithms\src\leetcode\top\287. Find the Duplicate Number\firstSubmission.ts", "TypeScript", 0, 0, 0, 14, 0, 0, 2, 16
"d:\typescript-algorithms\src\leetcode\top\289. Game of Life\firstSubmission.ts", "TypeScript", 0, 0, 0, 35, 0, 0, 2, 37
"d:\typescript-algorithms\src\leetcode\top\29. Divide Two Integers\firstSubmission.ts", "TypeScript", 0, 0, 0, 31, 0, 0, 1, 32
"d:\typescript-algorithms\src\leetcode\top\297. Serialize and Deserialize Binary Tree\TreeNode.ts", "TypeScript", 0, 0, 0, 10, 0, 0, 1, 11
"d:\typescript-algorithms\src\leetcode\top\297. Serialize and Deserialize Binary Tree\firstSubmission.ts", "TypeScript", 0, 0, 0, 45, 0, 3, 3, 51
"d:\typescript-algorithms\src\leetcode\top\3. Longest Substring Without Repeating Characters\firstSubmission.ts", "TypeScript", 0, 0, 0, 27, 0, 0, 2, 29
"d:\typescript-algorithms\src\leetcode\top\300. Longest Increasing Subsequence\firstSubmission.ts", "TypeScript", 0, 0, 0, 16, 0, 0, 1, 17
"d:\typescript-algorithms\src\leetcode\top\322. Coin Change\firstSubmission.ts", "TypeScript", 0, 0, 0, 10, 0, 0, 2, 12
"d:\typescript-algorithms\src\leetcode\top\324. Wiggle Sort II\firstSubmission.ts", "TypeScript", 0, 0, 0, 15, 0, 0, 1, 16
"d:\typescript-algorithms\src\leetcode\top\326. Power of Three\finalSubmission.ts", "TypeScript", 0, 0, 0, 3, 0, 0, 1, 4
"d:\typescript-algorithms\src\leetcode\top\326. Power of Three\firstSubmission.ts", "TypeScript", 0, 0, 0, 7, 0, 0, 1, 8
"d:\typescript-algorithms\src\leetcode\top\328. Odd Even Linked List\ListNode.ts", "TypeScript", 0, 0, 0, 8, 0, 0, 1, 9
"d:\typescript-algorithms\src\leetcode\top\328. Odd Even Linked List\firstSubmission.ts", "TypeScript", 0, 0, 0, 17, 0, 0, 2, 19
"d:\typescript-algorithms\src\leetcode\top\34. Find First and Last Position of Element in Sorted Array\firstSubmission.ts", "TypeScript", 0, 0, 0, 20, 0, 1, 2, 23
"d:\typescript-algorithms\src\leetcode\top\36. Valid Sudoku\firstSubmission.ts", "TypeScript", 0, 0, 0, 51, 0, 0, 4, 55
"d:\typescript-algorithms\src\leetcode\top\38. Count and Say\firstSubmission.ts", "TypeScript", 0, 0, 0, 20, 0, 0, 1, 21
"d:\typescript-algorithms\src\leetcode\top\384. Shuffle an Array\firstSubmission.ts", "TypeScript", 0, 0, 0, 20, 0, 0, 3, 23
"d:\typescript-algorithms\src\leetcode\top\384. Shuffle an Array\secondSubmission.ts", "TypeScript", 0, 0, 0, 20, 0, 0, 3, 23
"d:\typescript-algorithms\src\leetcode\top\387. First Unique Character in a String\firstSubmission.ts", "TypeScript", 0, 0, 0, 16, 0, 0, 1, 17
"d:\typescript-algorithms\src\leetcode\top\395. Longest Substring with At Least K Repeating Characters\firstSubmission.ts", "TypeScript", 0, 0, 0, 28, 0, 0, 6, 34
"d:\typescript-algorithms\src\leetcode\top\4. Median of Two Sorted Arrays\finalSubmission.ts", "TypeScript", 0, 0, 0, 41, 0, 2, 1, 44
"d:\typescript-algorithms\src\leetcode\top\4. Median of Two Sorted Arrays\firstSubmission.ts", "TypeScript", 0, 0, 0, 34, 0, 0, 1, 35
"d:\typescript-algorithms\src\leetcode\top\41. First Missing Positive\finalSubmission.ts", "TypeScript", 0, 0, 0, 14, 0, 0, 1, 15
"d:\typescript-algorithms\src\leetcode\top\41. First Missing Positive\firstSubmission.ts", "TypeScript", 0, 0, 0, 14, 0, 0, 2, 16
"d:\typescript-algorithms\src\leetcode\top\412. Fizz Buzz\firstSubmission.ts", "TypeScript", 0, 0, 0, 18, 0, 0, 4, 22
"d:\typescript-algorithms\src\leetcode\top\42. Trapping Rain Water\firstSubmission.ts", "TypeScript", 0, 0, 0, 18, 0, 0, 1, 19
"d:\typescript-algorithms\src\leetcode\top\44. Wildcard Matching\firstSubmission.ts", "TypeScript", 0, 0, 0, 25, 0, 1, 2, 28
"d:\typescript-algorithms\src\leetcode\top\454. 4Sum II\firstSubmission.ts", "TypeScript", 0, 0, 0, 20, 0, 0, 1, 21
"d:\typescript-algorithms\src\leetcode\top\454. 4Sum II\secondSubmission.ts", "TypeScript", 0, 0, 0, 26, 0, 0, 1, 27
"d:\typescript-algorithms\src\leetcode\top\46. Permutations\firstSubmission.ts", "TypeScript", 0, 0, 0, 16, 0, 0, 5, 21
"d:\typescript-algorithms\src\leetcode\top\48. Rotate Image\firstSubmission.ts", "TypeScript", 0, 0, 0, 12, 0, 3, 1, 16
"d:\typescript-algorithms\src\leetcode\top\49. Group Anagrams\firstSubmission.ts", "TypeScript", 0, 0, 0, 12, 0, 0, 1, 13
"d:\typescript-algorithms\src\leetcode\top\5. Longest Palindromic Substring\finalSubmission.ts", "TypeScript", 0, 0, 0, 20, 0, 1, 1, 22
"d:\typescript-algorithms\src\leetcode\top\5. Longest Palindromic Substring\firstSubmission.ts", "TypeScript", 0, 0, 0, 19, 0, 0, 1, 20
"d:\typescript-algorithms\src\leetcode\top\50. Pow(x, n)\finalSubmission.ts", "TypeScript", 0, 0, 0, 17, 0, 0, 2, 19
"d:\typescript-algorithms\src\leetcode\top\50. Pow(x, n)\firstSubmission.ts", "TypeScript", 0, 0, 0, 20, 0, 0, 1, 21
"d:\typescript-algorithms\src\leetcode\top\53. Maximum Subarray\firstSubmission.ts", "TypeScript", 0, 0, 0, 11, 0, 0, 1, 12
"d:\typescript-algorithms\src\leetcode\top\54. Spiral Matrix\firstSubmission.ts", "TypeScript", 0, 0, 0, 27, 0, 0, 1, 28
"d:\typescript-algorithms\src\leetcode\top\55. Jump Game\firstSubmission.ts", "TypeScript", 0, 0, 0, 12, 0, 0, 1, 13
"d:\typescript-algorithms\src\leetcode\top\56. Merge Intervals\firstSubmission.ts", "TypeScript", 0, 0, 0, 15, 0, 0, 1, 16
"d:\typescript-algorithms\src\leetcode\top\62. Unique Paths\firstSubmission.ts", "TypeScript", 0, 0, 0, 17, 0, 0, 1, 18
"d:\typescript-algorithms\src\leetcode\top\66. Plus One\firstSubmission.ts", "TypeScript", 0, 0, 0, 5, 0, 0, 1, 6
"d:\typescript-algorithms\src\leetcode\top\69. Sqrt(x)\firstSubmission.ts", "TypeScript", 0, 0, 0, 18, 0, 0, 1, 19
"d:\typescript-algorithms\src\leetcode\top\7. Reverse Integer\finalSubmission.ts", "TypeScript", 0, 0, 0, 12, 0, 0, 1, 13
"d:\typescript-algorithms\src\leetcode\top\7. Reverse Integer\firstSubmission.ts", "TypeScript", 0, 0, 0, 16, 0, 0, 2, 18
"d:\typescript-algorithms\src\leetcode\top\70. Climbing Stairs\firstSubmission.ts", "TypeScript", 0, 0, 0, 12, 0, 0, 1, 13
"d:\typescript-algorithms\src\leetcode\top\73. Set Matrix Zeroes\firstSubmission.ts", "TypeScript", 0, 0, 0, 20, 0, 3, 1, 24
"d:\typescript-algorithms\src\leetcode\top\73. Set Matrix Zeroes\secondSubmission.ts", "TypeScript", 0, 0, 0, 28, 0, 0, 1, 29
"d:\typescript-algorithms\src\leetcode\top\75. Sort Colors\firstSubmission.ts", "TypeScript", 0, 0, 0, 14, 0, 3, 1, 18
"d:\typescript-algorithms\src\leetcode\top\76. Minimum Window Substring\firstSubmission.ts", "TypeScript", 0, 0, 0, 44, 0, 1, 1, 46
"d:\typescript-algorithms\src\leetcode\top\78. Subsets\firstSubmission.ts", "TypeScript", 0, 0, 0, 13, 0, 0, 1, 14
"d:\typescript-algorithms\src\leetcode\top\78. Subsets\secondSubmission.ts", "TypeScript", 0, 0, 0, 6, 0, 0, 1, 7
"d:\typescript-algorithms\src\leetcode\top\79. Word Search\firstSubmisison.ts", "TypeScript", 0, 0, 0, 45, 0, 0, 6, 51
"d:\typescript-algorithms\src\leetcode\top\8. String to Integer (atoi)\firstSubmission.ts", "TypeScript", 0, 0, 0, 43, 0, 0, 1, 44
"d:\typescript-algorithms\src\leetcode\top\8. String to Integer (atoi)\secondSubmission.ts", "TypeScript", 0, 0, 0, 15, 0, 0, 1, 16
"d:\typescript-algorithms\src\leetcode\top\84. Largest Rectangle in Histogram\firstSubmission.ts", "TypeScript", 0, 0, 0, 26, 0, 1, 4, 31
"d:\typescript-algorithms\src\leetcode\top\88. Merge Sorted Array\firstSubmission.ts", "TypeScript", 0, 0, 0, 28, 0, 3, 1, 32
"d:\typescript-algorithms\src\leetcode\top\91. Decode Ways\firstSubmission.ts", "TypeScript", 0, 0, 0, 17, 0, 0, 1, 18
"d:\typescript-algorithms\src\leetcode\top\94. Binary Tree Inorder Traversal\TreeNode.ts", "TypeScript", 0, 0, 0, 10, 0, 0, 1, 11
"d:\typescript-algorithms\src\leetcode\top\94. Binary Tree Inorder Traversal\finalSubmission.ts", "TypeScript", 0, 0, 0, 14, 0, 0, 6, 20
"d:\typescript-algorithms\src\leetcode\top\94. Binary Tree Inorder Traversal\firstSubmission.ts", "TypeScript", 0, 0, 0, 15, 0, 0, 3, 18
"d:\typescript-algorithms\src\leetcode\top\98. Validate Binary Search Tree\TreeNode.ts", "TypeScript", 0, 0, 0, 10, 0, 0, 1, 11
"d:\typescript-algorithms\src\leetcode\top\98. Validate Binary Search Tree\firstSubmission.ts", "TypeScript", 0, 0, 0, 18, 0, 13, 3, 34
"d:\typescript-algorithms\tsconfig.json", "JSON with Comments", 0, 22, 0, 0, 0, 43, 8, 73
"Total", "-", 29, 22, 13, 12605, 6, 931, 1548, 15154